1041158,19-Jan,1.1,1,9.01,1,1,SK Telecom T1,27.2,0,0,1,4.9855,0,9.620533333,1,1,15.98858333,3294,3384,-90,5186,5365,-179,4831,4903,-72,86,87,-1,143,136,7
1041158,19-Jan,1.1,1,9.01,2,1,SK Telecom T1,27.2,0,0,0,4.9855,1,9.620533333,1,1,15.98858333,3217,3411,-194,5073,5031,42,3447,3910,-463,62,59,3,95,85,10
1041158,19-Jan,1.1,1,9.01,3,1,SK Telecom T1,27.2,0,0,0,4.9855,0,9.620533333,1,1,15.98858333,3463,3286,177,5442,5043,399,4905,4753,152,92,88,4,150,137,13
1041158,19-Jan,1.1,1,9.01,4,1,SK Telecom T1,27.2,0,0,0,4.9855,0,9.620533333,1,1,15.98858333,3751,3277,474,5989,4981,1008,3368,3363,5,99,91,8,153,143,10
1041158,19-Jan,1.1,1,9.01,5,1,SK Telecom T1,27.2,0,0,0,4.9855,0,9.620533333,1,1,15.98858333,2635,2028,607,4078,2977,1101,3133,2357,776,17,2,15,27,7,20
1041158,19-Jan,1.1,1,9.01,100,1,SK Telecom T1,27.2,0,0,1,4.9855,1,9.620533333,1,1,15.98858333,16360,15386,974,25768,23397,2371,19684,19286,398,356,327,29,568,508,60
1041166,19-Jan,1.1,2,9.01,6,2,SK Telecom T1,33.1,0,0,1,6.538666667,0,9.0345,0,1,12.4476,2738,4037,-1299,4557,5840,-1283,3812,4601,-789,61,92,-31,109,129,-20
1041166,19-Jan,1.1,2,9.01,7,2,SK Telecom T1,33.1,0,0,0,6.538666667,1,9.0345,0,1,12.4476,3477,3327,150,5440,5170,270,3946,3737,209,66,54,12,103,86,17
1041166,19-Jan,1.1,2,9.01,8,2,SK Telecom T1,33.1,0,0,0,6.538666667,0,9.0345,0,1,12.4476,3641,3501,140,5381,5210,171,4890,4593,297,83,79,4,138,129,9
1041166,19-Jan,1.1,2,9.01,9,2,SK Telecom T1,33.1,0,0,0,6.538666667,0,9.0345,0,1,12.4476,3940,3251,689,6209,5146,1063,3182,3236,-54,98,85,13,148,127,21
1041166,19-Jan,1.1,2,9.01,10,2,SK Telecom T1,33.1,0,0,0,6.538666667,0,9.0345,0,1,12.4476,2684,2195,489,4745,3494,1251,3199,2716,483,17,3,14,30,11,19
1041166,19-Jan,1.1,2,9.01,200,2,SK Telecom T1,33.1,0,0,1,6.538666667,1,9.0345,0,1,12.4476,16480,16311,169,26332,24860,1472,19029,18883,146,325,313,12,528,482,46
1041734,19-Jan,1.3,1,9.01,6,2,SK Telecom T1,28.91666667,0,0,0,8.301633333,0,10.89908333,0,1,16.23073333,3202,3160,42,5138,5066,72,4376,4669,-293,84,84,0,143,146,-3
1041734,19-Jan,1.3,1,9.01,7,2,SK Telecom T1,28.91666667,0,0,0,8.301633333,1,10.89908333,0,1,16.23073333,2510,3576,-1066,4373,5069,-696,2837,3849,-1012,42,63,-21,84,89,-5
1041734,19-Jan,1.3,1,9.01,8,2,SK Telecom T1,28.91666667,0,0,1,8.301633333,0,10.89908333,0,1,16.23073333,3286,3628,-342,5538,5525,13,4662,5122,-460,91,95,-4,153,149,4
1041734,19-Jan,1.3,1,9.01,9,2,SK Telecom T1,28.91666667,0,0,0,8.301633333,0,10.89908333,0,1,16.23073333,3247,3342,-95,4890,5017,-127,3327,3244,83,88,86,2,141,140,1
1041734,19-Jan,1.3,1,9.01,10,2,SK Telecom T1,28.91666667,0,0,0,8.301633333,0,10.89908333,0,1,16.23073333,2112,2527,-415,2994,3643,-649,2602,2786,-184,3,13,-10,7,21,-14
1041734,19-Jan,1.3,1,9.01,200,2,SK Telecom T1,28.91666667,0,0,1,8.301633333,1,10.89908333,0,1,16.23073333,14357,16233,-1876,22933,24320,-1387,17804,19670,-1866,308,341,-33,528,545,-17
1041756,19-Jan,1.3,2,9.01,1,1,SK Telecom T1,25.33333333,0,0,0,12.5211,0,9.185333333,1,1,15.06461667,3434,3241,193,5724,4975,749,4964,4755,209,88,86,2,146,129,17
1041756,19-Jan,1.3,2,9.01,2,1,SK Telecom T1,25.33333333,0,1,0,12.5211,1,9.185333333,1,1,15.06461667,2777,3326,-549,4402,5442,-1040,3159,3882,-723,53,68,-15,76,101,-25
1041756,19-Jan,1.3,2,9.01,3,1,SK Telecom T1,25.33333333,1,0,0,12.5211,0,9.185333333,1,1,15.06461667,3191,3237,-46,5653,4940,713,4504,4493,11,81,87,-6,122,139,-17
1041756,19-Jan,1.3,2,9.01,4,1,SK Telecom T1,25.33333333,0,0,0,12.5211,0,9.185333333,1,1,15.06461667,3646,3309,337,6449,5343,1106,3234,3314,-80,89,88,1,156,145,11
1041756,19-Jan,1.3,2,9.01,5,1,SK Telecom T1,25.33333333,0,0,0,12.5211,0,9.185333333,1,1,15.06461667,2561,2555,6,4259,3964,295,2827,2843,-16,15,14,1,27,24,3
1041756,19-Jan,1.3,2,9.01,100,1,SK Telecom T1,25.33333333,1,1,0,12.5211,1,9.185333333,1,1,15.06461667,15609,15668,-59,26487,24664,1823,18688,19287,-599,326,343,-17,527,538,-11
1043122,19-Jan,2.2,1,9.01,6,2,SK Telecom T1,33.21666667,0,1,0,9.045116667,0,9.514833333,0,0,17.67026667,3744,3237,507,5525,4780,745,4935,4404,531,94,84,10,137,122,15
1043122,19-Jan,2.2,1,9.01,7,2,SK Telecom T1,33.21666667,1,0,0,9.045116667,0,9.514833333,0,0,17.67026667,3376,3474,-98,5076,4944,132,3619,4203,-584,49,76,-27,84,108,-24
1043122,19-Jan,2.2,1,9.01,8,2,SK Telecom T1,33.21666667,0,0,0,9.045116667,0,9.514833333,0,0,17.67026667,3195,3356,-161,5198,5359,-161,4905,4646,259,84,92,-8,140,152,-12
1043122,19-Jan,2.2,1,9.01,9,2,SK Telecom T1,33.21666667,0,0,0,9.045116667,0,9.514833333,0,0,17.67026667,3634,3447,187,5909,5552,357,3224,3327,-103,93,98,-5,153,154,-1
1043122,19-Jan,2.2,1,9.01,10,2,SK Telecom T1,33.21666667,0,0,0,9.045116667,0,9.514833333,0,0,17.67026667,2447,2519,-72,3891,3903,-12,2930,2880,50,11,13,-2,24,24,0
1043122,19-Jan,2.2,1,9.01,200,2,SK Telecom T1,33.21666667,1,1,0,9.045116667,0,9.514833333,0,0,17.67026667,16396,16033,363,25599,24538,1061,19613,19460,153,331,363,-32,538,560,-22
1043158,19-Jan,2.2,2,9.01,1,1,SK Telecom T1,29.28333333,0,0,0,3.46805,0,10.45073333,1,0,12.06748333,2975,3125,-150,4662,4887,-225,4047,4674,-627,66,68,-2,113,123,-10
1043158,19-Jan,2.2,2,9.01,2,1,SK Telecom T1,29.28333333,1,0,0,3.46805,0,10.45073333,1,0,12.06748333,3462,3391,71,5110,5094,16,3524,3406,118,59,58,1,82,94,-12
1043158,19-Jan,2.2,2,9.01,3,1,SK Telecom T1,29.28333333,0,1,0,3.46805,0,10.45073333,1,0,12.06748333,3242,2891,351,5050,4648,402,4129,4260,-131,76,69,7,132,118,14
1043158,19-Jan,2.2,2,9.01,4,1,SK Telecom T1,29.28333333,0,0,0,3.46805,0,10.45073333,1,0,12.06748333,3483,4178,-695,5405,6875,-1470,3585,3477,108,91,90,1,136,157,-21
1043158,19-Jan,2.2,2,9.01,5,1,SK Telecom T1,29.28333333,0,0,0,3.46805,0,10.45073333,1,0,12.06748333,2249,2617,-368,3622,4529,-907,2303,2880,-577,11,12,-1,26,22,4
1043158,19-Jan,2.2,2,9.01,100,1,SK Telecom T1,29.28333333,1,1,0,3.46805,0,10.45073333,1,0,12.06748333,15411,16202,-791,23849,26033,-2184,17588,18697,-1109,303,297,6,489,514,-25
1043165,19-Jan,2.2,3,9.01,6,2,SK Telecom T1,30.16666667,0,0,0,2.3196,0,8.257783333,0,0,13.90053333,3223,3843,-620,5352,6418,-1066,3611,5131,-1520,50,92,-42,108,144,-36
1043165,19-Jan,2.2,3,9.01,7,2,SK Telecom T1,30.16666667,0,0,1,2.3196,0,8.257783333,0,0,13.90053333,3075,3588,-513,4297,6147,-1850,3329,3439,-110,49,50,-1,75,100,-25
1043165,19-Jan,2.2,3,9.01,8,2,SK Telecom T1,30.16666667,0,0,0,2.3196,0,8.257783333,0,0,13.90053333,2913,4638,-1725,4399,6597,-2198,4187,4798,-611,71,73,-2,112,133,-21
1043165,19-Jan,2.2,3,9.01,9,2,SK Telecom T1,30.16666667,0,0,0,2.3196,0,8.257783333,0,0,13.90053333,3633,3770,-137,5478,5889,-411,3104,3972,-868,90,95,-5,147,156,-9
1043165,19-Jan,2.2,3,9.01,10,2,SK Telecom T1,30.16666667,0,0,0,2.3196,0,8.257783333,0,0,13.90053333,2411,2618,-207,3703,4570,-867,2491,2133,358,12,11,1,25,29,-4
1043165,19-Jan,2.2,3,9.01,200,2,SK Telecom T1,30.16666667,0,0,1,2.3196,0,8.257783333,0,0,13.90053333,15255,18457,-3202,23229,29621,-6392,16722,19473,-2751,272,321,-49,467,562,-95
982640,19-Jan,2.5,1,9.01,1,1,SK Telecom T1,37.35,0,1,0,3.608133333,0,6.885433333,0,1,15.48025,3287,3515,-228,6046,5635,411,4234,4437,-203,73,76,-3,126,119,7
982640,19-Jan,2.5,1,9.01,2,1,SK Telecom T1,37.35,1,0,0,3.608133333,1,6.885433333,0,1,15.48025,3937,3208,729,5722,4724,998,3701,3868,-167,54,56,-2,70,88,-18
982640,19-Jan,2.5,1,9.01,3,1,SK Telecom T1,37.35,0,0,0,3.608133333,0,6.885433333,0,1,15.48025,3002,3564,-562,4671,5393,-722,4487,4968,-481,76,98,-22,119,147,-28
982640,19-Jan,2.5,1,9.01,4,1,SK Telecom T1,37.35,0,0,0,3.608133333,0,6.885433333,0,1,15.48025,3561,3164,397,5815,5151,664,3591,3423,168,98,84,14,155,134,21
982640,19-Jan,2.5,1,9.01,5,1,SK Telecom T1,37.35,0,0,0,3.608133333,0,6.885433333,0,1,15.48025,2486,2094,392,3748,3096,652,3045,2771,274,14,4,10,21,5,16
982640,19-Jan,2.5,1,9.01,100,1,SK Telecom T1,37.35,1,1,0,3.608133333,1,6.885433333,0,1,15.48025,16273,15545,728,26002,23999,2003,19058,19467,-409,315,318,-3,491,493,-2
992747,19-Jan,2.5,2,9.01,6,2,SK Telecom T1,33.15,1,0,0,7.332416667,0,9.463333333,1,0,12.41083333,3937,3267,670,6223,5106,1117,4674,4442,232,82,72,10,134,129,5
992747,19-Jan,2.5,2,9.01,7,2,SK Telecom T1,33.15,0,1,0,7.332416667,1,9.463333333,1,0,12.41083333,3290,3688,-398,5559,5529,30,3620,4111,-491,57,66,-9,98,89,9
992747,19-Jan,2.5,2,9.01,8,2,SK Telecom T1,33.15,0,0,0,7.332416667,0,9.463333333,1,0,12.41083333,3281,3440,-159,5602,5524,78,4744,4791,-47,88,89,-1,142,160,-18
992747,19-Jan,2.5,2,9.01,9,2,SK Telecom T1,33.15,0,0,0,7.332416667,0,9.463333333,1,0,12.41083333,3908,3288,620,6226,6005,221,3271,3211,60,96,83,13,149,138,11
992747,19-Jan,2.5,2,9.01,10,2,SK Telecom T1,33.15,0,0,0,7.332416667,0,9.463333333,1,0,12.41083333,2541,2476,65,4069,4124,-55,2837,2799,38,14,3,11,28,11,17
992747,19-Jan,2.5,2,9.01,200,2,SK Telecom T1,33.15,1,1,0,7.332416667,1,9.463333333,1,0,12.41083333,16957,16159,798,27679,26288,1391,19146,19354,-208,337,313,24,551,527,24
992751,19-Jan,2.5,3,9.01,1,1,SK Telecom T1,33.91666667,0,1,0,5.62745,0,9.408916667,1,1,16.92718333,3704,3314,390,5279,4975,304,4755,4259,496,82,90,-8,125,138,-13
992751,19-Jan,2.5,3,9.01,2,1,SK Telecom T1,33.91666667,1,0,0,5.62745,0,9.408916667,1,1,16.92718333,3685,3246,439,5086,4990,96,3869,3705,164,58,63,-5,88,104,-16
992751,19-Jan,2.5,3,9.01,3,1,SK Telecom T1,33.91666667,0,0,0,5.62745,0,9.408916667,1,1,16.92718333,3377,3408,-31,5062,4922,140,4695,4744,-49,88,86,2,138,134,4
992751,19-Jan,2.5,3,9.01,4,1,SK Telecom T1,33.91666667,0,0,0,5.62745,0,9.408916667,1,1,16.92718333,3642,3347,295,5864,5073,791,3142,3638,-496,87,91,-4,144,143,1
992751,19-Jan,2.5,3,9.01,5,1,SK Telecom T1,33.91666667,0,0,0,5.62745,0,9.408916667,1,1,16.92718333,2587,2473,114,3891,3875,16,2653,2262,391,14,14,0,26,26,0
992751,19-Jan,2.5,3,9.01,100,1,SK Telecom T1,33.91666667,1,1,0,5.62745,0,9.408916667,1,1,16.92718333,16995,15788,1207,25182,23835,1347,19114,18608,506,329,344,-15,521,545,-24
1060844,19-Jan,3.2,1,9.02,6,2,SK Telecom T1,36.86666667,0,0,0,28.05928333,0,17.25263333,0,0,16.60683333,3139,3381,-242,4741,5102,-361,4817,4875,-58,81,97,-16,123,147,-24
1060844,19-Jan,3.2,1,9.02,7,2,SK Telecom T1,36.86666667,0,0,0,28.05928333,1,17.25263333,0,0,16.60683333,3344,3110,234,4664,4661,3,3867,3272,595,70,60,10,96,90,6
1060844,19-Jan,3.2,1,9.02,8,2,SK Telecom T1,36.86666667,0,0,0,28.05928333,0,17.25263333,0,0,16.60683333,3267,3611,-344,5160,5804,-644,4274,4780,-506,93,100,-7,151,162,-11
1060844,19-Jan,3.2,1,9.02,9,2,SK Telecom T1,36.86666667,0,0,0,28.05928333,0,17.25263333,0,0,16.60683333,3300,3370,-70,5087,5216,-129,3370,3175,195,89,92,-3,143,152,-9
1060844,19-Jan,3.2,1,9.02,10,2,SK Telecom T1,36.86666667,0,0,1,28.05928333,0,17.25263333,0,0,16.60683333,2587,2626,-39,4009,3829,180,2987,3079,-92,14,17,-3,28,30,-2
1060844,19-Jan,3.2,1,9.02,200,2,SK Telecom T1,36.86666667,0,0,1,28.05928333,1,17.25263333,0,0,16.60683333,15637,16098,-461,23661,24612,-951,19315,19181,134,347,366,-19,541,581,-40
1060866,19-Jan,3.2,2,9.02,1,1,SK Telecom T1,28.85,0,0,0,4.3123,0,9.678383333,1,0,11.98683333,2998,3490,-492,4786,5463,-677,4250,4753,-503,78,85,-7,111,124,-13
1060866,19-Jan,3.2,2,9.02,2,1,SK Telecom T1,28.85,0,0,0,4.3123,0,9.678383333,1,0,11.98683333,3085,3908,-823,4417,6516,-2099,3581,4105,-524,60,75,-15,86,116,-30
1060866,19-Jan,3.2,2,9.02,3,1,SK Telecom T1,28.85,0,0,0,4.3123,0,9.678383333,1,0,11.98683333,3094,4009,-915,5056,6209,-1153,4097,5043,-946,81,91,-10,132,138,-6
1060866,19-Jan,3.2,2,9.02,4,1,SK Telecom T1,28.85,0,0,0,4.3123,0,9.678383333,1,0,11.98683333,3239,4112,-873,5111,7125,-2014,3228,3891,-663,89,95,-6,133,156,-23
1060866,19-Jan,3.2,2,9.02,5,1,SK Telecom T1,28.85,0,0,1,4.3123,0,9.678383333,1,0,11.98683333,2180,3131,-951,3296,4966,-1670,2315,2577,-262,12,18,-6,16,36,-20
1060866,19-Jan,3.2,2,9.02,100,1,SK Telecom T1,28.85,0,0,1,4.3123,0,9.678383333,1,0,11.98683333,14596,18650,-4054,22666,30279,-7613,17471,20369,-2898,320,364,-44,478,570,-92
1051690,19-Jan,3.5,1,9.02,1,1,SK Telecom T1,29.7,0,0,0,3.014366667,0,7.18135,1,1,15.8914,3310,3314,-4,5290,5226,64,4905,4758,147,91,89,2,153,147,6
1051690,19-Jan,3.5,1,9.02,2,1,SK Telecom T1,29.7,1,0,0,3.014366667,1,7.18135,1,1,15.8914,3814,2892,922,5859,4365,1494,3864,3068,796,70,57,13,97,87,10
1051690,19-Jan,3.5,1,9.02,3,1,SK Telecom T1,29.7,0,1,0,3.014366667,0,7.18135,1,1,15.8914,3588,3359,229,6233,5082,1151,4947,4708,239,97,93,4,150,146,4
1051690,19-Jan,3.5,1,9.02,4,1,SK Telecom T1,29.7,0,0,0,3.014366667,0,7.18135,1,1,15.8914,3711,3420,291,6436,5408,1028,3406,3497,-91,97,96,1,157,143,14
1051690,19-Jan,3.5,1,9.02,5,1,SK Telecom T1,29.7,0,0,0,3.014366667,0,7.18135,1,1,15.8914,2327,2657,-330,3671,3917,-246,2723,2533,190,12,16,-4,18,27,-9
1051690,19-Jan,3.5,1,9.02,100,1,SK Telecom T1,29.7,1,1,0,3.014366667,1,7.18135,1,1,15.8914,16750,15642,1108,27489,23998,3491,19845,18564,1281,367,351,16,575,550,25
1051713,19-Jan,3.5,2,9.02,6,2,SK Telecom T1,25.56666667,1,0,0,6.121333333,0,16.92353333,1,1,15.35088333,4016,2743,1273,5992,4941,1051,4909,3845,1064,85,69,16,143,110,33
1051713,19-Jan,3.5,2,9.02,7,2,SK Telecom T1,25.56666667,0,1,0,6.121333333,1,16.92353333,1,1,15.35088333,3361,2807,554,5045,4300,745,3417,3088,329,58,49,9,97,72,25
1051713,19-Jan,3.5,2,9.02,8,2,SK Telecom T1,25.56666667,0,0,0,6.121333333,0,16.92353333,1,1,15.35088333,3140,3386,-246,5065,5178,-113,4498,4844,-346,80,95,-15,141,148,-7
1051713,19-Jan,3.5,2,9.02,9,2,SK Telecom T1,25.56666667,0,0,0,6.121333333,0,16.92353333,1,1,15.35088333,3697,3480,217,5848,5069,779,3488,3473,15,103,99,4,157,144,13
1051713,19-Jan,3.5,2,9.02,10,2,SK Telecom T1,25.56666667,0,0,0,6.121333333,0,16.92353333,1,1,15.35088333,2490,2492,-2,3981,3842,139,2950,2926,24,14,14,0,25,23,2
1051713,19-Jan,3.5,2,9.02,200,2,SK Telecom T1,25.56666667,1,1,0,6.121333333,1,16.92353333,1,1,15.35088333,16704,14908,1796,25931,23330,2601,19262,18176,1086,340,326,14,563,497,66
1000735,19-Jan,4.1,1,9.03,1,1,SK Telecom T1,36.6,1,0,0,14.64215,0,12.11068333,1,0,14.8968,2435,2394,41,4973,3633,1340,4411,4266,145,3,38,-35,43,50,-7
1000735,19-Jan,4.1,1,9.03,2,1,SK Telecom T1,36.6,0,1,0,14.64215,0,12.11068333,1,0,14.8968,3203,3200,3,5301,4914,387,3304,3526,-222,64,71,-7,102,114,-12
1000735,19-Jan,4.1,1,9.03,3,1,SK Telecom T1,36.6,0,0,0,14.64215,0,12.11068333,1,0,14.8968,3153,2538,615,4971,4542,429,4747,5078,-331,81,23,58,133,76,57
1000735,19-Jan,4.1,1,9.03,4,1,SK Telecom T1,36.6,0,0,0,14.64215,0,12.11068333,1,0,14.8968,3332,3867,-535,5056,5853,-797,3121,3323,-202,93,96,-3,142,123,19
1000735,19-Jan,4.1,1,9.03,5,1,SK Telecom T1,36.6,0,0,0,14.64215,0,12.11068333,1,0,14.8968,1698,2136,-438,2645,4130,-1485,3062,3183,-121,0,18,-18,4,61,-57
1000735,19-Jan,4.1,1,9.03,100,1,SK Telecom T1,36.6,1,1,0,14.64215,0,12.11068333,1,0,14.8968,13821,14135,-314,22946,23072,-126,18645,19376,-731,241,246,-5,424,424,0
1010799,19-Jan,4.1,2,9.03,6,2,SK Telecom T1,38.46666667,0,0,0,2.13645,0,7.05915,1,1,13.00471667,2982,3215,-233,5099,4782,317,4136,4573,-437,70,78,-8,115,119,-4
1010799,19-Jan,4.1,2,9.03,7,2,SK Telecom T1,38.46666667,1,0,0,2.13645,1,7.05915,1,1,13.00471667,3496,3394,102,5090,4765,325,3424,3339,85,60,57,3,84,86,-2
1010799,19-Jan,4.1,2,9.03,8,2,SK Telecom T1,38.46666667,0,0,0,2.13645,0,7.05915,1,1,13.00471667,3340,3657,-317,5235,5202,33,4654,4799,-145,88,28,60,132,60,72
1010799,19-Jan,4.1,2,9.03,9,2,SK Telecom T1,38.46666667,0,1,0,2.13645,0,7.05915,1,1,13.00471667,4004,3151,853,7043,4941,2102,3377,3122,255,98,82,16,162,134,28
1010799,19-Jan,4.1,2,9.03,10,2,SK Telecom T1,38.46666667,0,1,0,2.13645,0,7.05915,1,1,13.00471667,2181,1869,312,3385,2934,451,2881,2459,422,15,14,1,26,25,1
1010799,19-Jan,4.1,2,9.03,200,2,SK Telecom T1,38.46666667,1,1,0,2.13645,1,7.05915,1,1,13.00471667,16003,15286,717,25852,22624,3228,18472,18292,180,331,259,72,519,424,95
1000799,19-Jan,4.1,3,9.03,1,1,SK Telecom T1,35.08333333,0,0,0,7.9992,0,13.73371667,1,1,15.85655,3553,2853,700,5849,4387,1462,4346,4463,-117,84,66,18,145,111,34
1000799,19-Jan,4.1,3,9.03,2,1,SK Telecom T1,35.08333333,0,0,0,7.9992,1,13.73371667,1,1,15.85655,3401,2640,761,5081,4250,831,3464,2576,888,64,41,23,95,74,21
1000799,19-Jan,4.1,3,9.03,3,1,SK Telecom T1,35.08333333,0,1,0,7.9992,0,13.73371667,1,1,15.85655,3285,2445,840,4942,4216,726,4614,4754,-140,79,23,56,129,48,81
1000799,19-Jan,4.1,3,9.03,4,1,SK Telecom T1,35.08333333,0,1,0,7.9992,0,13.73371667,1,1,15.85655,3748,3380,368,5676,5151,525,3363,3156,207,96,94,2,155,148,7
1000799,19-Jan,4.1,3,9.03,5,1,SK Telecom T1,35.08333333,1,0,0,7.9992,0,13.73371667,1,1,15.85655,2574,2124,450,3669,3140,529,3118,3038,80,17,18,-1,28,33,-5
1000799,19-Jan,4.1,3,9.03,100,1,SK Telecom T1,35.08333333,1,1,0,7.9992,1,13.73371667,1,1,15.85655,16561,13442,3119,25217,21144,4073,18905,17987,918,340,242,98,552,414,138
1011816,19-Jan,4.4,1,9.03,6,2,SK Telecom T1,36.73333333,0,0,1,6.4558,0,10.9804,0,0,13.67101667,2847,3310,-463,4400,5782,-1382,4182,4431,-249,61,70,-9,105,120,-15
1011816,19-Jan,4.4,1,9.03,7,2,SK Telecom T1,36.73333333,0,0,0,6.4558,1,10.9804,0,0,13.67101667,3414,2893,521,4869,4826,43,3591,3097,494,60,57,3,91,89,2
1011816,19-Jan,4.4,1,9.03,8,2,SK Telecom T1,36.73333333,0,0,0,6.4558,0,10.9804,0,0,13.67101667,3440,3592,-152,5401,6657,-1256,4952,5041,-89,97,104,-7,161,162,-1
1011816,19-Jan,4.4,1,9.03,9,2,SK Telecom T1,36.73333333,0,0,0,6.4558,0,10.9804,0,0,13.67101667,3349,3445,-96,5375,5363,12,3151,3572,-421,93,94,-1,160,143,17
1011816,19-Jan,4.4,1,9.03,10,2,SK Telecom T1,36.73333333,0,0,0,6.4558,0,10.9804,0,0,13.67101667,2035,1945,90,2998,3060,-62,2801,2475,326,14,13,1,22,19,3
1011816,19-Jan,4.4,1,9.03,200,2,SK Telecom T1,36.73333333,0,0,1,6.4558,1,10.9804,0,0,13.67101667,15085,15185,-100,23043,25688,-2645,18677,18616,61,325,338,-13,539,533,6
1011915,19-Jan,4.4,2,9.03,1,1,SK Telecom T1,31.65,0,0,0,4.624233333,0,6.420966667,1,1,11.79896667,3849,3132,717,6146,4804,1342,4758,4644,114,89,81,8,145,132,13
1011915,19-Jan,4.4,2,9.03,2,1,SK Telecom T1,31.65,0,1,0,4.624233333,1,6.420966667,1,1,11.79896667,3237,2816,421,5054,4347,707,3457,2605,852,60,51,9,85,78,7
1011915,19-Jan,4.4,2,9.03,3,1,SK Telecom T1,31.65,0,0,0,4.624233333,0,6.420966667,1,1,11.79896667,3237,3736,-499,5213,5657,-444,4846,4614,232,89,90,-1,142,137,5
1011915,19-Jan,4.4,2,9.03,4,1,SK Telecom T1,31.65,0,1,0,4.624233333,0,6.420966667,1,1,11.79896667,3344,3279,65,5072,5657,-585,3091,3262,-171,86,87,-1,137,144,-7
1011915,19-Jan,4.4,2,9.03,5,1,SK Telecom T1,31.65,1,0,0,4.624233333,0,6.420966667,1,1,11.79896667,2332,2193,139,3429,3371,58,2234,2800,-566,10,16,-6,22,27,-5
1011915,19-Jan,4.4,2,9.03,100,1,SK Telecom T1,31.65,1,1,0,4.624233333,1,6.420966667,1,1,11.79896667,15999,15156,843,24914,23836,1078,18386,17925,461,334,325,9,531,518,13
1011933,19-Jan,4.4,3,9.03,6,2,SK Telecom T1,37.5,0,1,0,7.037966667,0,8.313466667,1,1,15.94253333,3535,3253,282,5550,5001,549,4825,4531,294,91,84,7,151,132,19
1011933,19-Jan,4.4,3,9.03,7,2,SK Telecom T1,37.5,0,0,0,7.037966667,1,8.313466667,1,1,15.94253333,3162,2994,168,4599,4269,330,3481,3196,285,68,53,15,98,76,22
1011933,19-Jan,4.4,3,9.03,8,2,SK Telecom T1,37.5,1,0,0,7.037966667,0,8.313466667,1,1,15.94253333,3662,3260,402,5691,5165,526,4606,4674,-68,91,86,5,157,145,12
1011933,19-Jan,4.4,3,9.03,9,2,SK Telecom T1,37.5,0,0,0,7.037966667,0,8.313466667,1,1,15.94253333,3391,3281,110,5171,5315,-144,3645,2999,646,97,87,10,150,154,-4
1011933,19-Jan,4.4,3,9.03,10,2,SK Telecom T1,37.5,0,0,0,7.037966667,0,8.313466667,1,1,15.94253333,2006,2119,-113,2940,3242,-302,2722,2800,-78,14,16,-2,24,29,-5
1011933,19-Jan,4.4,3,9.03,200,2,SK Telecom T1,37.5,1,1,0,7.037966667,1,8.313466667,1,1,15.94253333,15756,14907,849,23951,22992,959,19279,18200,1079,361,326,35,580,536,44
1013228,19-Jan,5.1,1,9.03,6,2,SK Telecom T1,51.18333333,0,0,0,2.9053,0,8.272566667,1,1,14.77688333,3292,3487,-195,4717,5161,-444,5001,5132,-131,86,88,-2,123,123,0
1013228,19-Jan,5.1,1,9.03,7,2,SK Telecom T1,51.18333333,1,0,0,2.9053,1,8.272566667,1,1,14.77688333,3462,3127,335,5254,4579,675,3242,3642,-400,59,67,-8,93,86,7
1013228,19-Jan,5.1,1,9.03,8,2,SK Telecom T1,51.18333333,0,0,0,2.9053,0,8.272566667,1,1,14.77688333,3249,3501,-252,5050,5617,-567,4764,4978,-214,85,101,-16,135,148,-13
1013228,19-Jan,5.1,1,9.03,9,2,SK Telecom T1,51.18333333,0,1,0,2.9053,0,8.272566667,1,1,14.77688333,3572,3090,482,6102,4718,1384,3301,3451,-150,98,83,15,165,130,35
1013228,19-Jan,5.1,1,9.03,10,2,SK Telecom T1,51.18333333,0,1,0,2.9053,0,8.272566667,1,1,14.77688333,2190,1903,287,3954,2881,1073,2987,2305,682,16,4,12,30,8,22
1013228,19-Jan,5.1,1,9.03,200,2,SK Telecom T1,51.18333333,1,1,0,2.9053,1,8.272566667,1,1,14.77688333,15765,15108,657,25077,22956,2121,19295,19508,-213,344,343,1,546,495,51
1013262,19-Jan,5.1,2,9.03,1,1,SK Telecom T1,30.88333333,0,1,0,11.71686667,0,8.512433333,1,1,11.99628333,3051,3187,-136,5278,5280,-2,4265,4306,-41,76,75,1,122,121,1
1013262,19-Jan,5.1,2,9.03,2,1,SK Telecom T1,30.88333333,1,0,0,11.71686667,1,8.512433333,1,1,11.99628333,3067,2683,384,5153,4912,241,3301,2487,814,59,48,11,76,85,-9
1013262,19-Jan,5.1,2,9.03,3,1,SK Telecom T1,30.88333333,0,1,0,11.71686667,0,8.512433333,1,1,11.99628333,3534,3445,89,5886,5509,377,4931,5068,-137,100,96,4,142,137,5
1013262,19-Jan,5.1,2,9.03,4,1,SK Telecom T1,30.88333333,0,0,0,11.71686667,0,8.512433333,1,1,11.99628333,3350,3290,60,5210,6198,-988,3123,3252,-129,92,91,1,137,147,-10
1013262,19-Jan,5.1,2,9.03,5,1,SK Telecom T1,30.88333333,0,1,0,11.71686667,0,8.512433333,1,1,11.99628333,2026,1981,45,3451,3564,-113,2976,2987,-11,16,12,4,27,19,8
1013262,19-Jan,5.1,2,9.03,100,1,SK Telecom T1,30.88333333,1,1,0,11.71686667,1,8.512433333,1,1,11.99628333,15028,14586,442,24978,25463,-485,18596,18100,496,343,322,21,504,509,-5
1014903,19-Jan,5.5,1,9.03,6,2,SK Telecom T1,45.35,0,0,0,5.325766667,0,6.8829,1,1,15.31858333,3100,3625,-525,5124,5265,-141,4574,4510,64,79,86,-7,131,121,10
1014903,19-Jan,5.5,1,9.03,7,2,SK Telecom T1,45.35,0,0,1,5.325766667,1,6.8829,1,1,15.31858333,3102,3405,-303,4472,4786,-314,3372,3352,20,59,67,-8,79,95,-16
1014903,19-Jan,5.5,1,9.03,8,2,SK Telecom T1,45.35,0,0,0,5.325766667,0,6.8829,1,1,15.31858333,3534,3592,-58,5630,5404,226,4780,4955,-175,85,103,-18,137,159,-22
1014903,19-Jan,5.5,1,9.03,9,2,SK Telecom T1,45.35,0,0,0,5.325766667,0,6.8829,1,1,15.31858333,3231,3328,-97,4862,5108,-246,3075,3136,-61,86,88,-2,131,131,0
1014903,19-Jan,5.5,1,9.03,10,2,SK Telecom T1,45.35,0,0,0,5.325766667,0,6.8829,1,1,15.31858333,2050,2136,-86,3199,3025,174,3016,2900,116,15,15,0,24,24,0
1014903,19-Jan,5.5,1,9.03,200,2,SK Telecom T1,45.35,0,0,1,5.325766667,1,6.8829,1,1,15.31858333,15017,16086,-1069,23287,23588,-301,18817,18853,-36,324,359,-35,502,530,-28
1004826,19-Jan,5.5,2,9.03,1,1,SK Telecom T1,45.43333333,1,0,0,8.564616667,0,12.42036667,0,1,14.97295,3659,3092,567,5598,4626,972,4779,4555,224,88,83,5,134,126,8
1004826,19-Jan,5.5,2,9.03,2,1,SK Telecom T1,45.43333333,0,1,0,8.564616667,0,12.42036667,0,1,14.97295,3924,2967,957,5515,5007,508,4232,3291,941,73,56,17,98,97,1
1004826,19-Jan,5.5,2,9.03,3,1,SK Telecom T1,45.43333333,0,0,0,8.564616667,0,12.42036667,0,1,14.97295,3296,3224,72,5133,5103,30,4750,4530,220,90,85,5,149,139,10
1004826,19-Jan,5.5,2,9.03,4,1,SK Telecom T1,45.43333333,0,0,0,8.564616667,0,12.42036667,0,1,14.97295,3643,3371,272,5856,4951,905,3325,3314,11,96,93,3,140,138,2
1004826,19-Jan,5.5,2,9.03,5,1,SK Telecom T1,45.43333333,0,0,0,8.564616667,0,12.42036667,0,1,14.97295,2069,2076,-7,3201,3167,34,2854,3019,-165,14,18,-4,26,31,-5
1004826,19-Jan,5.5,2,9.03,100,1,SK Telecom T1,45.43333333,1,1,0,8.564616667,0,12.42036667,0,1,14.97295,16591,14730,1861,25303,22854,2449,19940,18709,1231,361,335,26,547,531,16
1004838,19-Jan,5.5,3,9.03,6,2,SK Telecom T1,35.4,0,0,0,17.07008333,0,11.01546667,1,1,17.57791667,2993,3273,-280,4566,5034,-468,4565,4700,-135,77,85,-8,125,138,-13
1004838,19-Jan,5.5,3,9.03,7,2,SK Telecom T1,35.4,0,1,0,17.07008333,1,11.01546667,1,1,17.57791667,2933,3176,-243,4591,4648,-57,3046,3433,-387,49,66,-17,87,97,-10
1004838,19-Jan,5.5,3,9.03,8,2,SK Telecom T1,35.4,0,1,0,17.07008333,0,11.01546667,1,1,17.57791667,3316,3554,-238,5342,5445,-103,4816,5091,-275,93,101,-8,158,160,-2
1004838,19-Jan,5.5,3,9.03,9,2,SK Telecom T1,35.4,1,0,0,17.07008333,0,11.01546667,1,1,17.57791667,3440,3363,77,5560,5129,431,3357,3319,38,97,94,3,165,150,15
1004838,19-Jan,5.5,3,9.03,10,2,SK Telecom T1,35.4,0,1,0,17.07008333,0,11.01546667,1,1,17.57791667,2077,2050,27,3116,3281,-165,2704,2760,-56,14,15,-1,23,29,-6
1004838,19-Jan,5.5,3,9.03,200,2,SK Telecom T1,35.4,1,1,0,17.07008333,1,11.01546667,1,1,17.57791667,14759,15416,-657,23175,23537,-362,18488,19303,-815,330,361,-31,558,574,-16
1031118,19-Jan,6.2,1,9.04,1,1,SK Telecom T1,29.31666667,0,0,0,4.55035,0,7.978766667,1,1,14.02191667,3718,3301,417,6252,4866,1386,5080,4706,374,104,88,16,163,137,26
1031118,19-Jan,6.2,1,9.04,2,1,SK Telecom T1,29.31666667,0,0,0,4.55035,1,7.978766667,1,1,14.02191667,3594,3315,279,5189,4674,515,3928,3364,564,76,54,22,104,84,20
1031118,19-Jan,6.2,1,9.04,3,1,SK Telecom T1,29.31666667,0,0,0,4.55035,0,7.978766667,1,1,14.02191667,4104,3148,956,6788,4944,1844,5127,4688,439,103,77,26,155,136,19
1031118,19-Jan,6.2,1,9.04,4,1,SK Telecom T1,29.31666667,0,0,1,4.55035,0,7.978766667,1,1,14.02191667,3770,4143,-373,5816,5916,-100,3401,3359,42,92,91,1,150,140,10
1031118,19-Jan,6.2,1,9.04,5,1,SK Telecom T1,29.31666667,0,0,0,4.55035,0,7.978766667,1,1,14.02191667,2214,2244,-30,3426,3176,250,2817,2595,222,15,13,2,25,19,6
1031118,19-Jan,6.2,1,9.04,100,1,SK Telecom T1,29.31666667,0,0,1,4.55035,1,7.978766667,1,1,14.02191667,17400,16151,1249,27471,23576,3895,20353,18712,1641,390,323,67,597,516,81
1031154,19-Jan,6.2,2,9.04,6,2,SK Telecom T1,34.78333333,0,0,0,12.29985,0,9.0345,1,1,16.63858333,3249,3297,-48,5091,5176,-85,4728,4861,-133,90,89,1,141,133,8
1031154,19-Jan,6.2,2,9.04,7,2,SK Telecom T1,34.78333333,0,0,0,12.29985,0,9.0345,1,1,16.63858333,3205,3103,102,5047,4437,610,3479,3324,155,66,60,6,102,86,16
1031154,19-Jan,6.2,2,9.04,8,2,SK Telecom T1,34.78333333,0,0,1,12.29985,0,9.0345,1,1,16.63858333,3179,3558,-379,4916,5723,-807,4339,4840,-501,85,95,-10,135,152,-17
1031154,19-Jan,6.2,2,9.04,9,2,SK Telecom T1,34.78333333,0,0,0,12.29985,0,9.0345,1,1,16.63858333,3356,3393,-37,5293,5272,21,3403,3533,-130,93,95,-2,153,152,1
1031154,19-Jan,6.2,2,9.04,10,2,SK Telecom T1,34.78333333,0,0,0,12.29985,0,9.0345,1,1,16.63858333,2091,2052,39,2932,3071,-139,2608,2618,-10,15,15,0,22,24,-2
1031154,19-Jan,6.2,2,9.04,200,2,SK Telecom T1,34.78333333,0,0,1,12.29985,0,9.0345,1,1,16.63858333,15080,15403,-323,23279,23679,-400,18557,19176,-619,349,354,-5,553,547,6
1021695,19-Jan,6.4,1,9.04,6,2,SK Telecom T1,36.63333333,0,0,0,2.362116667,0,7.7624,1,1,12.00315,4332,3013,1319,7265,4544,2721,5122,4493,629,104,71,33,171,117,54
1021695,19-Jan,6.4,1,9.04,7,2,SK Telecom T1,36.63333333,1,0,0,2.362116667,1,7.7624,1,1,12.00315,3701,2880,821,5185,4587,598,3376,3608,-232,51,55,-4,83,93,-10
1021695,19-Jan,6.4,1,9.04,8,2,SK Telecom T1,36.63333333,0,1,0,2.362116667,0,7.7624,1,1,12.00315,3721,2966,755,5580,4483,1097,4828,3998,830,85,73,12,138,117,21
1021695,19-Jan,6.4,1,9.04,9,2,SK Telecom T1,36.63333333,0,0,0,2.362116667,0,7.7624,1,1,12.00315,2748,3462,-714,4728,5678,-950,3249,3326,-77,63,87,-24,123,154,-31
1021695,19-Jan,6.4,1,9.04,10,2,SK Telecom T1,36.63333333,0,0,0,2.362116667,0,7.7624,1,1,12.00315,1875,2549,-674,2835,3367,-532,2059,2446,-387,7,5,2,17,8,9
1021695,19-Jan,6.4,1,9.04,200,2,SK Telecom T1,36.63333333,1,1,0,2.362116667,1,7.7624,1,1,12.00315,16377,14870,1507,25593,22659,2934,18634,17871,763,310,291,19,532,489,43
1031640,19-Jan,6.4,2,9.04,1,1,SK Telecom T1,27.68333333,0,0,0,10.49035,0,8.627733333,0,0,11.20871667,3165,3267,-102,6031,5774,257,4875,4796,79,81,86,-5,129,130,-1
1031640,19-Jan,6.4,2,9.04,2,1,SK Telecom T1,27.68333333,0,1,0,10.49035,1,8.627733333,0,0,11.20871667,3193,2986,207,5156,4973,183,3400,3425,-25,70,50,20,97,87,10
1031640,19-Jan,6.4,2,9.04,3,1,SK Telecom T1,27.68333333,0,0,0,10.49035,0,8.627733333,0,0,11.20871667,3414,3049,365,5788,5431,357,4848,4811,37,95,83,12,162,140,22
1031640,19-Jan,6.4,2,9.04,4,1,SK Telecom T1,27.68333333,1,0,0,10.49035,0,8.627733333,0,0,11.20871667,3389,3192,197,6331,4604,1727,3242,2916,326,96,86,10,148,114,34
1031640,19-Jan,6.4,2,9.04,5,1,SK Telecom T1,27.68333333,0,1,0,10.49035,0,8.627733333,0,0,11.20871667,2005,2091,-86,3602,3057,545,2950,2891,59,13,15,-2,27,24,3
1031640,19-Jan,6.4,2,9.04,100,1,SK Telecom T1,27.68333333,1,1,0,10.49035,1,8.627733333,0,0,11.20871667,15166,14585,581,26908,23839,3069,19315,18839,476,355,320,35,563,495,68
1033333,19-Jan,7.2,1,9.04,1,1,SK Telecom T1,39.86666667,0,1,0,17.6828,0,12.19448333,1,1,15.81035,3296,3153,143,4936,4600,336,4795,4912,-117,90,83,7,139,123,16
1033333,19-Jan,7.2,1,9.04,2,1,SK Telecom T1,39.86666667,0,1,0,17.6828,1,12.19448333,1,1,15.81035,2945,3114,-169,4660,4280,380,3013,3413,-400,56,61,-5,92,81,11
1033333,19-Jan,7.2,1,9.04,3,1,SK Telecom T1,39.86666667,0,1,0,17.6828,0,12.19448333,1,1,15.81035,3501,3365,136,5193,5402,-209,4885,4940,-55,100,91,9,153,159,-6
1033333,19-Jan,7.2,1,9.04,4,1,SK Telecom T1,39.86666667,0,0,0,17.6828,0,12.19448333,1,1,15.81035,3610,3449,161,5458,5448,10,3335,3173,162,98,93,5,154,150,4
1033333,19-Jan,7.2,1,9.04,5,1,SK Telecom T1,39.86666667,1,0,0,17.6828,0,12.19448333,1,1,15.81035,2238,2066,172,3296,3454,-158,3011,2861,150,14,17,-3,26,40,-14
1033333,19-Jan,7.2,1,9.04,100,1,SK Telecom T1,39.86666667,1,1,0,17.6828,1,12.19448333,1,1,15.81035,15590,15147,443,23543,23184,359,19039,19299,-260,358,345,13,564,553,11
1023345,19-Jan,7.2,2,9.04,6,2,SK Telecom T1,39.25,0,0,0,4.466366667,0,16.10628333,0,0,16.28516667,3212,3442,-230,5301,5204,97,4640,4985,-345,87,95,-8,143,148,-5
1023345,19-Jan,7.2,2,9.04,7,2,SK Telecom T1,39.25,0,0,0,4.466366667,1,16.10628333,0,0,16.28516667,3016,3127,-111,4606,4328,278,3070,3248,-178,60,53,7,86,77,9
1023345,19-Jan,7.2,2,9.04,8,2,SK Telecom T1,39.25,0,0,0,4.466366667,0,16.10628333,0,0,16.28516667,3165,3447,-282,5548,5466,82,4678,4964,-286,83,98,-15,134,162,-28
1023345,19-Jan,7.2,2,9.04,9,2,SK Telecom T1,39.25,0,0,0,4.466366667,0,16.10628333,0,0,16.28516667,3391,3899,-508,5460,5880,-420,3258,3051,207,94,95,-1,154,145,9
1023345,19-Jan,7.2,2,9.04,10,2,SK Telecom T1,39.25,0,0,1,4.466366667,0,16.10628333,0,0,16.28516667,2054,2580,-526,3165,3496,-331,2757,2983,-226,14,13,1,26,19,7
1023345,19-Jan,7.2,2,9.04,200,2,SK Telecom T1,39.25,0,0,1,4.466366667,1,16.10628333,0,0,16.28516667,14838,16495,-1657,24080,24374,-294,18403,19231,-828,338,354,-16,543,551,-8
1023353,19-Jan,7.2,3,9.04,1,1,SK Telecom T1,34.38333333,1,0,0,4.048866667,0,11.20405,0,0,18.09588333,3455,3201,254,4540,5352,-812,4505,4568,-63,78,61,17,98,98,0
1023353,19-Jan,7.2,3,9.04,2,1,SK Telecom T1,34.38333333,0,1,0,4.048866667,0,11.20405,0,0,18.09588333,2892,3823,-931,4240,5519,-1279,3028,4547,-1519,49,81,-32,74,118,-44
1023353,19-Jan,7.2,3,9.04,3,1,SK Telecom T1,34.38333333,0,0,0,4.048866667,0,11.20405,0,0,18.09588333,3318,3528,-210,5114,5285,-171,4843,4932,-89,91,103,-12,148,156,-8
1023353,19-Jan,7.2,3,9.04,4,1,SK Telecom T1,34.38333333,0,0,0,4.048866667,0,11.20405,0,0,18.09588333,3338,3510,-172,4740,5615,-875,3362,3205,157,89,96,-7,127,146,-19
1023353,19-Jan,7.2,3,9.04,5,1,SK Telecom T1,34.38333333,0,0,0,4.048866667,0,11.20405,0,0,18.09588333,1972,2158,-186,2950,3260,-310,2740,3111,-371,14,14,0,25,21,4
1023353,19-Jan,7.2,3,9.04,100,1,SK Telecom T1,34.38333333,1,1,0,4.048866667,0,11.20405,0,0,18.09588333,14975,16220,-1245,21584,25031,-3447,18478,20363,-1885,321,355,-34,472,539,-67
1070844,19-Jan,8.1,1,9.05,1,1,SK Telecom T1,39.11666667,0,1,0,6.105416667,0,15.66166667,1,1,12.9922,3426,3261,165,5143,5480,-337,5043,4636,407,88,90,-2,127,130,-3
1070844,19-Jan,8.1,1,9.05,2,1,SK Telecom T1,39.11666667,0,1,0,6.105416667,0,15.66166667,1,1,12.9922,3043,3090,-47,4425,4832,-407,3410,3082,328,60,57,3,91,83,8
1070844,19-Jan,8.1,1,9.05,3,1,SK Telecom T1,39.11666667,1,0,0,6.105416667,0,15.66166667,1,1,12.9922,3747,3822,-75,5469,5973,-504,4681,5134,-453,91,107,-16,141,163,-22
1070844,19-Jan,8.1,1,9.05,4,1,SK Telecom T1,39.11666667,0,0,0,6.105416667,0,15.66166667,1,1,12.9922,3320,3203,117,5631,5613,18,3150,3031,119,90,87,3,147,139,8
1070844,19-Jan,8.1,1,9.05,5,1,SK Telecom T1,39.11666667,0,0,0,6.105416667,0,15.66166667,1,1,12.9922,2030,2027,3,3415,3439,-24,2920,3035,-115,12,14,-2,22,26,-4
1070844,19-Jan,8.1,1,9.05,100,1,SK Telecom T1,39.11666667,1,1,0,6.105416667,0,15.66166667,1,1,12.9922,15566,15403,163,24083,25337,-1254,19204,18918,286,341,355,-14,528,541,-13
1080900,19-Jan,8.1,2,9.05,6,2,SK Telecom T1,33.21666667,0,0,0,5.337766667,0,18.46661667,1,1,18.50686667,3107,3069,38,5164,5029,135,4677,4642,35,78,80,-2,122,126,-4
1080900,19-Jan,8.1,2,9.05,7,2,SK Telecom T1,33.21666667,0,1,0,5.337766667,1,18.46661667,1,1,18.50686667,3459,2985,474,4977,4320,657,3729,3423,306,71,53,18,88,74,14
1080900,19-Jan,8.1,2,9.05,8,2,SK Telecom T1,33.21666667,0,0,0,5.337766667,0,18.46661667,1,1,18.50686667,3305,3852,-547,5033,5852,-819,4078,5075,-997,74,91,-17,124,139,-15
1080900,19-Jan,8.1,2,9.05,9,2,SK Telecom T1,33.21666667,0,1,0,5.337766667,0,18.46661667,1,1,18.50686667,3603,3269,334,5464,5206,258,3037,3220,-183,82,86,-4,136,149,-13
1080900,19-Jan,8.1,2,9.05,10,2,SK Telecom T1,33.21666667,1,0,0,5.337766667,0,18.46661667,1,1,18.50686667,2566,2000,566,3679,3149,530,2740,2324,416,15,13,2,26,28,-2
1080900,19-Jan,8.1,2,9.05,200,2,SK Telecom T1,33.21666667,1,1,0,5.337766667,1,18.46661667,1,1,18.50686667,16040,15175,865,24317,23556,761,18261,18684,-423,320,323,-3,496,516,-20
1080915,19-Jan,8.1,3,9.05,1,1,SK Telecom T1,34.95,0,0,0,9.72495,0,6.671983333,1,0,12.1423,3573,3021,552,6054,4476,1578,4964,4555,409,94,75,19,151,117,34
1080915,19-Jan,8.1,3,9.05,2,1,SK Telecom T1,34.95,0,1,0,9.72495,0,6.671983333,1,0,12.1423,3450,3247,203,5557,4897,660,3866,3415,451,60,67,-7,100,101,-1
1080915,19-Jan,8.1,3,9.05,3,1,SK Telecom T1,34.95,1,0,0,9.72495,0,6.671983333,1,0,12.1423,3983,3279,704,6455,5097,1358,5270,4677,593,103,91,12,166,148,18
1080915,19-Jan,8.1,3,9.05,4,1,SK Telecom T1,34.95,0,0,0,9.72495,0,6.671983333,1,0,12.1423,3308,3452,-144,5030,6009,-979,3375,3494,-119,90,96,-6,140,143,-3
1080915,19-Jan,8.1,3,9.05,5,1,SK Telecom T1,34.95,0,0,0,9.72495,0,6.671983333,1,0,12.1423,2324,1975,349,3358,3678,-320,2808,2830,-22,2,15,-13,11,26,-15
1080915,19-Jan,8.1,3,9.05,100,1,SK Telecom T1,34.95,1,1,0,9.72495,0,6.671983333,1,0,12.1423,16638,14974,1664,26454,24157,2297,20283,18971,1312,349,344,5,568,535,33
1071818,19-Jan,8.4,1,9.05,6,2,SK Telecom T1,29.78333333,0,0,1,8.0284,0,7.0895,0,0,12.1298,3309,3366,-57,4971,4906,65,4471,4535,-64,89,69,20,137,104,33
1071818,19-Jan,8.4,1,9.05,7,2,SK Telecom T1,29.78333333,0,0,0,8.0284,0,7.0895,0,0,12.1298,3022,3436,-414,4573,4740,-167,3447,4021,-574,58,77,-19,86,102,-16
1071818,19-Jan,8.4,1,9.05,8,2,SK Telecom T1,29.78333333,0,0,0,8.0284,0,7.0895,0,0,12.1298,3331,3369,-38,5692,5030,662,4811,4717,94,93,94,-1,149,140,9
1071818,19-Jan,8.4,1,9.05,9,2,SK Telecom T1,29.78333333,0,0,0,8.0284,0,7.0895,0,0,12.1298,3004,3941,-937,4718,7169,-2451,2789,3368,-579,74,91,-17,115,153,-38
1071818,19-Jan,8.4,1,9.05,10,2,SK Telecom T1,29.78333333,0,0,0,8.0284,0,7.0895,0,0,12.1298,2016,2364,-348,3619,4149,-530,3028,2950,78,14,14,0,28,26,2
1071818,19-Jan,8.4,1,9.05,200,2,SK Telecom T1,29.78333333,0,0,1,8.0284,0,7.0895,0,0,12.1298,14682,16476,-1794,23573,25994,-2421,18546,19591,-1045,328,345,-17,515,525,-10
1081886,19-Jan,8.4,2,9.05,1,1,SK Telecom T1,28,0,0,0,10.1278,0,10.94898333,1,1,12.98321667,3556,3167,389,6888,4279,2609,4728,4659,69,94,80,14,151,107,44
1081886,19-Jan,8.4,2,9.05,2,1,SK Telecom T1,28,0,1,0,10.1278,0,10.94898333,1,1,12.98321667,2945,3021,-76,4822,4628,194,3237,3030,207,57,58,-1,76,96,-20
1081886,19-Jan,8.4,2,9.05,3,1,SK Telecom T1,28,1,0,0,10.1278,0,10.94898333,1,1,12.98321667,3356,3513,-157,5871,5410,461,4626,4637,-11,93,81,12,144,133,11
1081886,19-Jan,8.4,2,9.05,4,1,SK Telecom T1,28,0,1,0,10.1278,0,10.94898333,1,1,12.98321667,3434,3321,113,5297,5232,65,3401,3177,224,98,90,8,152,149,3
1081886,19-Jan,8.4,2,9.05,5,1,SK Telecom T1,28,0,1,0,10.1278,0,10.94898333,1,1,12.98321667,2221,2096,125,3403,3236,167,2667,2593,74,19,14,5,31,25,6
1081886,19-Jan,8.4,2,9.05,100,1,SK Telecom T1,28,1,1,0,10.1278,0,10.94898333,1,1,12.98321667,15512,15118,394,26281,22785,3496,18659,18096,563,361,323,38,554,510,44
1081890,19-Jan,8.4,3,9.05,6,2,SK Telecom T1,28.8,0,0,0,5.5048,0,7.095433333,1,0,14.42593333,3663,3463,200,5734,5088,646,4787,4640,147,84,85,-1,124,125,-1
1081890,19-Jan,8.4,3,9.05,7,2,SK Telecom T1,28.8,0,1,0,5.5048,1,7.095433333,1,0,14.42593333,3357,2824,533,4729,4236,493,3617,2869,748,64,52,12,84,75,9
1081890,19-Jan,8.4,3,9.05,8,2,SK Telecom T1,28.8,0,0,0,5.5048,0,7.095433333,1,0,14.42593333,3286,3224,62,5435,4896,539,4590,4603,-13,88,88,0,135,119,16
1081890,19-Jan,8.4,3,9.05,9,2,SK Telecom T1,28.8,1,0,0,5.5048,0,7.095433333,1,0,14.42593333,3770,3381,389,5691,5566,125,3209,3347,-138,94,89,5,140,149,-9
1081890,19-Jan,8.4,3,9.05,10,2,SK Telecom T1,28.8,0,1,0,5.5048,0,7.095433333,1,0,14.42593333,2147,2206,-59,3229,3370,-141,2738,2434,304,14,13,1,25,21,4
1081890,19-Jan,8.4,3,9.05,200,2,SK Telecom T1,28.8,1,1,0,5.5048,1,7.095433333,1,0,14.42593333,16223,15098,1125,24818,23156,1662,18941,17893,1048,344,327,17,508,489,19
1083791,19-Jan,9.2,1,9.05,1,1,SK Telecom T1,39.51666667,0,0,0,14.094,0,11.76016667,0,0,14.86943333,3210,3341,-131,4539,5409,-870,4875,4942,-67,87,94,-7,120,143,-23
1083791,19-Jan,9.2,1,9.05,2,1,SK Telecom T1,39.51666667,0,0,0,14.094,0,11.76016667,0,0,14.86943333,3025,2950,75,4110,4533,-423,3251,2911,340,54,58,-4,75,88,-13
1083791,19-Jan,9.2,1,9.05,3,1,SK Telecom T1,39.51666667,0,0,0,14.094,0,11.76016667,0,0,14.86943333,3527,3409,118,5280,6161,-881,4884,4905,-21,102,92,10,155,149,6
1083791,19-Jan,9.2,1,9.05,4,1,SK Telecom T1,39.51666667,0,0,0,14.094,0,11.76016667,0,0,14.86943333,3458,3398,60,5341,5957,-616,3258,3487,-229,96,94,2,146,144,2
1083791,19-Jan,9.2,1,9.05,5,1,SK Telecom T1,39.51666667,0,0,1,14.094,0,11.76016667,0,0,14.86943333,2072,2020,52,3254,3411,-157,2728,2683,45,0,14,-14,0,28,-28
1083791,19-Jan,9.2,1,9.05,100,1,SK Telecom T1,39.51666667,0,0,1,14.094,0,11.76016667,0,0,14.86943333,15292,15118,174,22524,25471,-2947,18996,18928,68,339,352,-13,496,552,-56
1083842,19-Jan,9.2,2,9.05,6,2,SK Telecom T1,30.11666667,0,0,0,3.1969,0,6.89045,1,0,13.36221667,3134,3165,-31,4897,5247,-350,4479,4049,430,77,70,7,129,137,-8
1083842,19-Jan,9.2,2,9.05,7,2,SK Telecom T1,30.11666667,1,0,0,3.1969,0,6.89045,1,0,13.36221667,3804,3411,393,5907,4685,1222,3533,3311,222,60,62,-2,100,86,14
1083842,19-Jan,9.2,2,9.05,8,2,SK Telecom T1,30.11666667,0,1,0,3.1969,0,6.89045,1,0,13.36221667,3747,3201,546,5913,5062,851,4916,4761,155,102,83,19,166,135,31
1083842,19-Jan,9.2,2,9.05,9,2,SK Telecom T1,30.11666667,0,0,0,3.1969,0,6.89045,1,0,13.36221667,3836,3804,32,5864,6106,-242,3179,3442,-263,88,100,-12,147,160,-13
1083842,19-Jan,9.2,2,9.05,10,2,SK Telecom T1,30.11666667,0,0,0,3.1969,0,6.89045,1,0,13.36221667,2114,2318,-204,3212,3863,-651,2922,3206,-284,12,14,-2,23,22,1
1083842,19-Jan,9.2,2,9.05,200,2,SK Telecom T1,30.11666667,1,1,0,3.1969,0,6.89045,1,0,13.36221667,16635,15899,736,25793,24963,830,19029,18769,260,339,329,10,565,540,25
1030895,19-Jan,10.1,1,9.06,6,2,SK Telecom T1,32.2,0,0,0,5.414883333,0,6.058383333,0,0,13.4335,3146,3265,-119,4732,6131,-1399,4580,4699,-119,81,88,-7,126,133,-7
1030895,19-Jan,10.1,1,9.06,7,2,SK Telecom T1,32.2,0,1,0,5.414883333,1,6.058383333,0,0,13.4335,3491,3051,440,5065,4547,518,3440,3311,129,60,57,3,94,89,5
1030895,19-Jan,10.1,1,9.06,8,2,SK Telecom T1,32.2,0,0,0,5.414883333,0,6.058383333,0,0,13.4335,3175,3379,-204,5277,4989,288,4953,4729,224,83,79,4,137,122,15
1030895,19-Jan,10.1,1,9.06,9,2,SK Telecom T1,32.2,0,1,0,5.414883333,0,6.058383333,0,0,13.4335,3584,3536,48,5834,5789,45,3611,3452,159,94,99,-5,155,154,1
1030895,19-Jan,10.1,1,9.06,10,2,SK Telecom T1,32.2,1,0,0,5.414883333,0,6.058383333,0,0,13.4335,2618,2053,565,3825,3329,496,2865,2407,458,1,14,-13,1,27,-26
1030895,19-Jan,10.1,1,9.06,200,2,SK Telecom T1,32.2,1,1,0,5.414883333,1,6.058383333,0,0,13.4335,16014,15284,730,24733,24785,-52,19449,18598,851,319,337,-18,513,525,-12
1020987,19-Jan,10.1,2,9.06,1,1,SK Telecom T1,39.15,0,0,0,2.1203,0,10.10938333,0,0,15.32183333,2892,3470,-578,4521,6475,-1954,4145,5066,-921,69,79,-10,120,143,-23
1020987,19-Jan,10.1,2,9.06,2,1,SK Telecom T1,39.15,0,0,0,2.1203,1,10.10938333,0,0,15.32183333,3000,3192,-192,4383,4494,-111,3422,3107,315,53,51,2,83,77,6
1020987,19-Jan,10.1,2,9.06,3,1,SK Telecom T1,39.15,0,0,0,2.1203,0,10.10938333,0,0,15.32183333,3649,3489,160,5570,5270,300,4867,4893,-26,92,88,4,137,134,3
1020987,19-Jan,10.1,2,9.06,4,1,SK Telecom T1,39.15,0,0,1,2.1203,0,10.10938333,0,0,15.32183333,3738,4020,-282,5678,5646,32,3375,3559,-184,96,92,4,159,138,21
1020987,19-Jan,10.1,2,9.06,5,1,SK Telecom T1,39.15,0,0,0,2.1203,0,10.10938333,0,0,15.32183333,2133,2166,-33,3320,3210,110,2916,2475,441,17,14,3,29,23,6
1020987,19-Jan,10.1,2,9.06,100,1,SK Telecom T1,39.15,0,0,1,2.1203,1,10.10938333,0,0,15.32183333,15412,16337,-925,23472,25095,-1623,18725,19100,-375,327,324,3,528,515,13
1021578,19-Jan,10.3,1,9.06,1,1,SK Telecom T1,36.63333333,0,0,0,3.532933333,0,13.41588333,1,1,15.5826,2916,3261,-345,4994,4572,422,3947,4145,-198,64,73,-9,107,101,6
1021578,19-Jan,10.3,1,9.06,2,1,SK Telecom T1,36.63333333,1,0,0,3.532933333,1,13.41588333,1,1,15.5826,3349,3476,-127,5175,4797,378,2878,3174,-296,43,53,-10,72,76,-4
1021578,19-Jan,10.3,1,9.06,3,1,SK Telecom T1,36.63333333,0,0,0,3.532933333,0,13.41588333,1,1,15.5826,3144,3152,-8,5066,4733,333,4420,4281,139,81,84,-3,123,133,-10
1021578,19-Jan,10.3,1,9.06,4,1,SK Telecom T1,36.63333333,0,0,0,3.532933333,0,13.41588333,1,1,15.5826,3582,3307,275,5448,5240,208,3323,3463,-140,95,95,0,152,161,-9
1021578,19-Jan,10.3,1,9.06,5,1,SK Telecom T1,36.63333333,0,0,0,3.532933333,0,13.41588333,1,1,15.5826,2047,2337,-290,3069,3423,-354,2759,2981,-222,15,5,10,27,9,18
1021578,19-Jan,10.3,1,9.06,100,1,SK Telecom T1,36.63333333,1,0,0,3.532933333,1,13.41588333,1,1,15.5826,15038,15533,-495,23752,22765,987,17327,18044,-717,298,310,-12,481,480,1
1021616,19-Jan,10.3,2,9.06,6,2,SK Telecom T1,45.26666667,1,0,0,3.6832,0,9.2198,0,0,13.45176667,3818,2933,885,5646,5171,475,4635,4725,-90,87,70,17,125,124,1
1021616,19-Jan,10.3,2,9.06,7,2,SK Telecom T1,45.26666667,0,1,0,3.6832,0,9.2198,0,0,13.45176667,3285,2765,520,4955,4483,472,2504,2609,-105,49,48,1,80,77,3
1021616,19-Jan,10.3,2,9.06,8,2,SK Telecom T1,45.26666667,0,0,0,3.6832,0,9.2198,0,0,13.45176667,3496,3176,320,5751,5595,156,4928,4516,412,98,82,16,154,135,19
1021616,19-Jan,10.3,2,9.06,9,2,SK Telecom T1,45.26666667,0,0,0,3.6832,0,9.2198,0,0,13.45176667,2853,3542,-689,4615,6731,-2116,2885,3035,-150,62,79,-17,116,138,-22
1021616,19-Jan,10.3,2,9.06,10,2,SK Telecom T1,45.26666667,0,0,0,3.6832,0,9.2198,0,0,13.45176667,1998,2280,-282,2851,3621,-770,2462,2438,24,10,2,8,17,6,11
1021616,19-Jan,10.3,2,9.06,200,2,SK Telecom T1,45.26666667,1,1,0,3.6832,0,9.2198,0,0,13.45176667,15450,14696,754,23818,25601,-1783,17414,17323,91,306,281,25,492,480,12
1032986,2019-1P,R3,1,9.06,1,1,SK Telecom T1,39.21666667,0,0,1,6.103833333,0,12.48565,0,1,16.01263333,3565,3330,235,5174,5053,121,4602,4806,-204,86,69,17,130,122,8
1032986,2019-1P,R3,1,9.06,2,1,SK Telecom T1,39.21666667,0,0,0,6.103833333,1,12.48565,0,1,16.01263333,3510,3095,415,4740,4517,223,3498,3292,206,68,57,11,89,87,2
1032986,2019-1P,R3,1,9.06,3,1,SK Telecom T1,39.21666667,0,0,0,6.103833333,0,12.48565,0,1,16.01263333,3494,3537,-43,5559,5822,-263,4979,4833,146,100,97,3,166,160,6
1032986,2019-1P,R3,1,9.06,4,1,SK Telecom T1,39.21666667,0,0,0,6.103833333,0,12.48565,0,1,16.01263333,3566,3286,280,5952,5235,717,3432,3265,167,104,87,17,169,148,21
1032986,2019-1P,R3,1,9.06,5,1,SK Telecom T1,39.21666667,0,0,0,6.103833333,0,12.48565,0,1,16.01263333,2049,2015,34,3433,2932,501,2933,2562,371,13,16,-3,27,27,0
1032986,2019-1P,R3,1,9.06,100,1,SK Telecom T1,39.21666667,0,0,1,6.103833333,1,12.48565,0,1,16.01263333,16184,15263,921,24858,23559,1299,19444,18758,686,371,326,45,581,544,37
1033014,2019-1P,R3,2,9.06,6,2,SK Telecom T1,45.73333333,0,0,0,6.649116667,0,9.25635,0,0,14.83495,3086,3529,-443,4653,5810,-1157,4545,4696,-151,79,82,-3,126,142,-16
1033014,2019-1P,R3,2,9.06,7,2,SK Telecom T1,45.73333333,0,0,0,6.649116667,1,9.25635,0,0,14.83495,3127,3288,-161,4343,5196,-853,3391,3623,-232,63,65,-2,87,86,1
1033014,2019-1P,R3,2,9.06,8,2,SK Telecom T1,45.73333333,0,0,1,6.649116667,0,9.25635,0,0,14.83495,3410,3711,-301,5056,5912,-856,4734,4542,192,97,80,17,148,130,18
1033014,2019-1P,R3,2,9.06,9,2,SK Telecom T1,45.73333333,0,0,0,6.649116667,0,9.25635,0,0,14.83495,3426,3331,95,5627,5391,236,3373,3328,45,96,94,2,148,141,7
1033014,2019-1P,R3,2,9.06,10,2,SK Telecom T1,45.73333333,0,0,0,6.649116667,0,9.25635,0,0,14.83495,2087,2071,16,3405,3303,102,2703,2923,-220,15,16,-1,28,27,1
1033014,2019-1P,R3,2,9.06,200,2,SK Telecom T1,45.73333333,0,0,1,6.649116667,1,9.25635,0,0,14.83495,15136,15930,-794,23084,25612,-2528,18746,19112,-366,350,337,13,537,526,11
1033016,2019-1P,R3,3,9.06,1,1,SK Telecom T1,37.28333333,0,0,0,12.13245,0,15.8976,1,1,16.40765,3291,3454,-163,5237,5463,-226,4640,4964,-324,83,87,-4,143,143,0
1033016,2019-1P,R3,3,9.06,2,1,SK Telecom T1,37.28333333,0,0,0,12.13245,0,15.8976,1,1,16.40765,3156,3085,71,4445,4619,-174,3256,3321,-65,62,60,2,86,95,-9
1033016,2019-1P,R3,3,9.06,3,1,SK Telecom T1,37.28333333,0,1,0,12.13245,0,15.8976,1,1,16.40765,3286,3306,-20,5322,5177,145,4813,4917,-104,90,87,3,149,143,6
1033016,2019-1P,R3,3,9.06,4,1,SK Telecom T1,37.28333333,0,0,0,12.13245,0,15.8976,1,1,16.40765,3725,3426,299,5741,5804,-63,3513,3231,282,99,90,9,159,156,3
1033016,2019-1P,R3,3,9.06,5,1,SK Telecom T1,37.28333333,1,0,0,12.13245,0,15.8976,1,1,16.40765,2082,2045,37,3474,2957,517,2803,3055,-252,18,16,2,30,25,5
1033016,2019-1P,R3,3,9.06,100,1,SK Telecom T1,37.28333333,1,1,0,12.13245,0,15.8976,1,1,16.40765,15540,15316,224,24219,24020,199,19025,19488,-463,352,340,12,567,562,5
1023942,2019-1P,F,1,9.06,6,2,SK Telecom T1,38.75,0,0,0,0.69435,0,7.522633333,0,0,11.49041667,3382,3190,192,4701,4609,92,4450,4452,-2,76,65,11,110,103,7
1023942,2019-1P,F,1,9.06,7,2,SK Telecom T1,38.75,0,0,0,0.69435,0,7.522633333,0,0,11.49041667,3228,3270,-42,4548,5033,-485,3596,3460,136,60,66,-6,85,87,-2
1023942,2019-1P,F,1,9.06,8,2,SK Telecom T1,38.75,0,0,0,0.69435,0,7.522633333,0,0,11.49041667,3281,3509,-228,5110,5636,-526,4781,5013,-232,91,100,-9,146,157,-11
1023942,2019-1P,F,1,9.06,9,2,SK Telecom T1,38.75,0,0,0,0.69435,0,7.522633333,0,0,11.49041667,3412,2832,580,5695,4799,896,3309,3049,260,79,23,56,133,43,90
1023942,2019-1P,F,1,9.06,10,2,SK Telecom T1,38.75,0,0,1,0.69435,0,7.522633333,0,0,11.49041667,1916,3220,-1304,3082,5285,-2203,2328,3358,-1030,10,75,-65,17,107,-90
1023942,2019-1P,F,1,9.06,200,2,SK Telecom T1,38.75,0,0,1,0.69435,0,7.522633333,0,0,11.49041667,15219,16021,-802,23136,25362,-2226,18464,19332,-868,316,329,-13,491,497,-6
1023979,2019-1P,F,2,9.06,1,1,SK Telecom T1,29.73333333,1,0,0,1.612816667,0,13.90355,0,1,17.05936667,3501,3045,456,5213,4457,756,4536,4571,-35,79,78,1,127,116,11
1023979,2019-1P,F,2,9.06,2,1,SK Telecom T1,29.73333333,0,1,0,1.612816667,1,13.90355,0,1,17.05936667,3590,2912,678,5474,4363,1111,3075,3028,47,59,46,13,87,74,13
1023979,2019-1P,F,2,9.06,3,1,SK Telecom T1,29.73333333,0,1,0,1.612816667,0,13.90355,0,1,17.05936667,3567,3348,219,6204,5252,952,4636,4728,-92,93,91,2,143,136,7
1023979,2019-1P,F,2,9.06,4,1,SK Telecom T1,29.73333333,0,1,0,1.612816667,0,13.90355,0,1,17.05936667,3335,3787,-452,5237,5508,-271,3341,3245,96,91,89,2,141,138,3
1023979,2019-1P,F,2,9.06,5,1,SK Telecom T1,29.73333333,0,1,0,1.612816667,0,13.90355,0,1,17.05936667,2070,2185,-115,3273,3194,79,2461,2818,-357,16,17,-1,20,28,-8
1023979,2019-1P,F,2,9.06,100,1,SK Telecom T1,29.73333333,1,1,0,1.612816667,1,13.90355,0,1,17.05936667,16063,15277,786,25401,22774,2627,18049,18390,-341,338,321,17,518,492,26
1023980,2019-1P,F,3,9.06,6,2,SK Telecom T1,30.15,0,0,0,2.359716667,0,12.0188,0,0,14.40993333,3116,3105,11,4937,5613,-676,4682,4489,193,82,84,-2,134,140,-6
1023980,2019-1P,F,3,9.06,7,2,SK Telecom T1,30.15,0,1,0,2.359716667,0,12.0188,0,0,14.40993333,3033,2864,169,4648,4284,364,2923,2595,328,57,51,6,82,67,15
1023980,2019-1P,F,3,9.06,8,2,SK Telecom T1,30.15,0,0,0,2.359716667,0,12.0188,0,0,14.40993333,3159,3431,-272,5223,5232,-9,4487,4735,-248,85,89,-4,145,139,6
1023980,2019-1P,F,3,9.06,9,2,SK Telecom T1,30.15,1,0,0,2.359716667,0,12.0188,0,0,14.40993333,3551,2620,931,5422,4328,1094,3133,3050,83,68,20,48,123,58,65
1023980,2019-1P,F,3,9.06,10,2,SK Telecom T1,30.15,0,1,0,2.359716667,0,12.0188,0,0,14.40993333,2002,3607,-1605,3126,4965,-1839,2573,3315,-742,10,89,-79,21,107,-86
1023980,2019-1P,F,3,9.06,200,2,SK Telecom T1,30.15,1,1,0,2.359716667,0,12.0188,0,0,14.40993333,14861,15627,-766,23356,24422,-1066,17798,18184,-386,302,333,-31,505,511,-6
