730277,18-Feb,1.2,1,8.11,6,2,SK Telecom T1,26.6,0,0,0,8.440666667,0,5.530133333,0,1,12.11475,2954,3371,-417,4330,5438,-1108,4375,4838,-463,73,79,-6,107,135,-28
730277,18-Feb,1.2,1,8.11,7,2,SK Telecom T1,26.6,0,0,0,8.440666667,1,5.530133333,0,1,12.11475,3069,3208,-139,4428,6306,-1878,3532,3979,-447,63,63,0,83,99,-16
730277,18-Feb,1.2,1,8.11,8,2,SK Telecom T1,26.6,0,0,0,8.440666667,0,5.530133333,0,1,12.11475,3392,3279,113,4840,5421,-581,4549,4655,-106,93,88,5,129,127,2
730277,18-Feb,1.2,1,8.11,9,2,SK Telecom T1,26.6,0,0,1,8.440666667,0,5.530133333,0,1,12.11475,3250,3535,-285,5128,5891,-763,3244,3124,120,89,73,16,129,107,22
730277,18-Feb,1.2,1,8.11,10,2,SK Telecom T1,26.6,0,0,0,8.440666667,0,5.530133333,0,1,12.11475,2036,2288,-252,2990,3914,-924,3009,3173,-164,18,15,3,23,27,-4
730277,18-Feb,1.2,1,8.11,200,2,SK Telecom T1,26.6,0,0,1,8.440666667,1,5.530133333,0,1,12.11475,14701,15681,-980,21716,26970,-5254,18709,19769,-1060,336,318,18,471,495,-24
730298,18-Feb,1.2,2,8.11,1,1,SK Telecom T1,37.45,0,0,1,6.582916667,0,10.1825,0,1,15.12076667,3258,3975,-717,5321,6003,-682,4463,5033,-570,69,97,-28,124,160,-36
730298,18-Feb,1.2,2,8.11,2,1,SK Telecom T1,37.45,0,0,0,6.582916667,1,10.1825,0,1,15.12076667,3150,3124,26,4742,5139,-397,3403,3704,-301,61,64,-3,98,110,-12
730298,18-Feb,1.2,2,8.11,3,1,SK Telecom T1,37.45,0,0,0,6.582916667,0,10.1825,0,1,15.12076667,2972,3082,-110,4815,4652,163,3156,4080,-924,70,78,-8,122,122,0
730298,18-Feb,1.2,2,8.11,4,1,SK Telecom T1,37.45,0,0,0,6.582916667,0,10.1825,0,1,15.12076667,3203,2776,427,4798,4364,434,4032,3081,951,86,61,25,130,102,28
730298,18-Feb,1.2,2,8.11,5,1,SK Telecom T1,37.45,0,0,0,6.582916667,0,10.1825,0,1,15.12076667,2369,2113,256,3726,3263,463,2897,2691,206,31,14,17,55,22,33
730298,18-Feb,1.2,2,8.11,100,1,SK Telecom T1,37.45,0,0,1,6.582916667,1,10.1825,0,1,15.12076667,14952,15070,-118,23402,23421,-19,17951,18589,-638,317,314,3,529,516,13
720662,18-Feb,1.4,1,8.11,6,2,SK Telecom T1,29.46666667,0,0,0,8.16005,0,9.212266667,0,0,14.95685,3155,3398,-243,5124,5678,-554,4706,4581,125,82,95,-13,136,130,6
720662,18-Feb,1.4,1,8.11,7,2,SK Telecom T1,29.46666667,0,0,0,8.16005,1,9.212266667,0,0,14.95685,2966,2944,22,4466,5143,-677,3555,3377,178,63,51,12,83,75,8
720662,18-Feb,1.4,1,8.11,8,2,SK Telecom T1,29.46666667,0,0,0,8.16005,0,9.212266667,0,0,14.95685,3072,3288,-216,4967,5996,-1029,4400,4771,-371,78,88,-10,123,140,-17
720662,18-Feb,1.4,1,8.11,9,2,SK Telecom T1,29.46666667,0,0,0,8.16005,0,9.212266667,0,0,14.95685,3534,3567,-33,5073,5607,-534,3312,3122,190,92,84,8,130,140,-10
720662,18-Feb,1.4,1,8.11,10,2,SK Telecom T1,29.46666667,0,0,1,8.16005,0,9.212266667,0,0,14.95685,1878,1838,40,3260,3185,75,2777,2687,90,2,1,1,3,3,0
720662,18-Feb,1.4,1,8.11,200,2,SK Telecom T1,29.46666667,0,0,1,8.16005,1,9.212266667,0,0,14.95685,14605,15035,-430,22890,25609,-2719,18750,18538,212,317,319,-2,475,488,-13
720686,18-Feb,1.4,2,8.11,1,1,SK Telecom T1,23.75,0,0,0,2.642766667,0,8.87295,0,0,13.54011667,3333,3212,121,5465,5316,149,4600,4736,-136,90,82,8,160,142,18
720686,18-Feb,1.4,2,8.11,2,1,SK Telecom T1,23.75,0,0,0,2.642766667,0,8.87295,0,0,13.54011667,4227,4090,137,6048,7292,-1244,4359,4293,66,93,98,-5,132,157,-25
720686,18-Feb,1.4,2,8.11,3,1,SK Telecom T1,23.75,0,0,1,2.642766667,0,8.87295,0,0,13.54011667,2513,2503,10,3629,3859,-230,2842,2911,-69,10,24,-14,14,33,-19
720686,18-Feb,1.4,2,8.11,4,1,SK Telecom T1,23.75,0,0,0,2.642766667,0,8.87295,0,0,13.54011667,3581,3590,-9,5422,6485,-1063,3526,3698,-172,93,89,4,142,145,-3
720686,18-Feb,1.4,2,8.11,5,1,SK Telecom T1,23.75,0,0,0,2.642766667,0,8.87295,0,0,13.54011667,2066,2281,-215,3034,4028,-994,2833,2731,102,10,15,-5,21,29,-8
720686,18-Feb,1.4,2,8.11,100,1,SK Telecom T1,23.75,0,0,1,2.642766667,0,8.87295,0,0,13.54011667,15720,15676,44,23598,26980,-3382,18160,18369,-209,296,308,-12,469,506,-37
721233,18-Feb,2.2,1,8.11,1,1,SK Telecom T1,33.53333333,0,0,0,3.612733333,0,8.731966667,,1,20.57876667,3183,3482,-299,4822,5211,-389,4949,5188,-239,84,98,-14,136,151,-15
721233,18-Feb,2.2,1,8.11,2,1,SK Telecom T1,33.53333333,1,0,0,3.612733333,0,8.731966667,,1,20.57876667,3306,3039,267,5074,4167,907,3226,3651,-425,54,66,-12,89,85,4
721233,18-Feb,2.2,1,8.11,3,1,SK Telecom T1,33.53333333,0,1,0,3.612733333,0,8.731966667,,1,20.57876667,3376,3149,227,5509,4762,747,4565,4294,271,82,78,4,140,128,12
721233,18-Feb,2.2,1,8.11,4,1,SK Telecom T1,33.53333333,0,0,0,3.612733333,0,8.731966667,,1,20.57876667,3296,3341,-45,5516,5237,279,3265,3376,-111,80,79,1,130,130,0
721233,18-Feb,2.2,1,8.11,5,1,SK Telecom T1,33.53333333,0,0,0,3.612733333,0,8.731966667,,1,20.57876667,2082,2644,-562,3078,3970,-892,2668,3064,-396,4,6,-2,9,16,-7
721233,18-Feb,2.2,1,8.11,100,1,SK Telecom T1,33.53333333,1,1,0,3.612733333,0,8.731966667,,1,20.57876667,15243,15655,-412,23999,23347,652,18673,19573,-900,304,327,-23,504,510,-6
721271,18-Feb,2.2,2,8.11,6,2,SK Telecom T1,27.48333333,1,0,0,8.146916667,0,10.41761667,0,0,14.86806667,3580,2992,588,4915,5606,-691,4637,4228,409,84,71,13,118,122,-4
721271,18-Feb,2.2,2,8.11,7,2,SK Telecom T1,27.48333333,0,1,0,8.146916667,0,10.41761667,0,0,14.86806667,3270,2576,694,4870,4670,200,3770,2884,886,60,40,20,98,63,35
721271,18-Feb,2.2,2,8.11,8,2,SK Telecom T1,27.48333333,0,0,0,8.146916667,0,10.41761667,0,0,14.86806667,3353,3185,168,4828,5061,-233,4489,4489,0,92,85,7,133,138,-5
721271,18-Feb,2.2,2,8.11,9,2,SK Telecom T1,27.48333333,0,0,0,8.146916667,0,10.41761667,0,0,14.86806667,3136,3640,-504,4899,5947,-1048,3200,3308,-108,82,94,-12,135,151,-16
721271,18-Feb,2.2,2,8.11,10,2,SK Telecom T1,27.48333333,0,0,0,8.146916667,0,10.41761667,0,0,14.86806667,1995,2068,-73,2946,3363,-417,2699,2951,-252,14,3,11,24,8,16
721271,18-Feb,2.2,2,8.11,200,2,SK Telecom T1,27.48333333,1,1,0,8.146916667,0,10.41761667,0,0,14.86806667,15334,14461,873,22458,24647,-2189,18795,17860,935,332,293,39,508,482,26
721274,18-Feb,2.2,3,8.11,1,1,SK Telecom T1,29.95,0,0,0,7.806783333,0,10.10866667,0,0,16.91725,2989,3146,-157,4477,4591,-114,4375,4581,-206,73,81,-8,112,114,-2
721274,18-Feb,2.2,3,8.11,2,1,SK Telecom T1,29.95,1,0,0,7.806783333,1,10.10866667,0,0,16.91725,3698,2973,725,5229,4553,676,3807,3681,126,66,58,8,95,77,18
721274,18-Feb,2.2,3,8.11,3,1,SK Telecom T1,29.95,0,1,0,7.806783333,0,10.10866667,0,0,16.91725,3327,3053,274,5095,5140,-45,4631,4530,101,81,76,5,125,123,2
721274,18-Feb,2.2,3,8.11,4,1,SK Telecom T1,29.95,0,0,0,7.806783333,0,10.10866667,0,0,16.91725,3374,3391,-17,5167,4794,373,3255,3067,188,82,95,-13,127,137,-10
721274,18-Feb,2.2,3,8.11,5,1,SK Telecom T1,29.95,0,0,0,7.806783333,0,10.10866667,0,0,16.91725,2082,2144,-62,3076,3631,-555,2637,2798,-161,15,2,13,25,6,19
721274,18-Feb,2.2,3,8.11,100,1,SK Telecom T1,29.95,1,1,0,7.806783333,1,10.10866667,0,0,16.91725,15470,14707,763,23044,22709,335,18705,18657,48,317,312,5,484,457,27
721524,18-Feb,2.4,1,8.11,6,2,SK Telecom T1,39.28333333,0,0,0,5.84595,0,6.41205,1,1,9.7502,3624,3167,457,5588,5419,169,4934,4640,294,102,82,20,162,153,9
721524,18-Feb,2.4,1,8.11,7,2,SK Telecom T1,39.28333333,0,1,0,5.84595,1,6.41205,1,1,9.7502,3435,1983,1452,5243,3047,2196,3459,2537,922,63,14,49,104,27,77
721524,18-Feb,2.4,1,8.11,8,2,SK Telecom T1,39.28333333,0,0,0,5.84595,0,6.41205,1,1,9.7502,3654,4345,-691,5749,6902,-1153,4810,5472,-662,93,133,-40,156,218,-62
721524,18-Feb,2.4,1,8.11,9,2,SK Telecom T1,39.28333333,0,1,0,5.84595,0,6.41205,1,1,9.7502,3675,3209,466,5886,4761,1125,3292,3071,221,81,79,2,133,125,8
721524,18-Feb,2.4,1,8.11,10,2,SK Telecom T1,39.28333333,1,0,0,5.84595,0,6.41205,1,1,9.7502,2581,2013,568,3718,3180,538,2440,3060,-620,5,17,-12,9,33,-24
721524,18-Feb,2.4,1,8.11,200,2,SK Telecom T1,39.28333333,1,1,0,5.84595,1,6.41205,1,1,9.7502,16969,14717,2252,26184,23309,2875,18935,18780,155,344,325,19,564,556,8
721567,18-Feb,2.4,2,8.11,1,1,SK Telecom T1,27.66666667,0,0,0,3.737716667,0,8.161783333,1,0,17.56503333,3164,2970,194,4776,4621,155,4615,4143,472,87,73,14,131,119,12
721567,18-Feb,2.4,2,8.11,2,1,SK Telecom T1,27.66666667,0,0,0,3.737716667,0,8.161783333,1,0,17.56503333,3056,3902,-846,4836,6212,-1376,3323,4532,-1209,49,98,-49,78,174,-96
721567,18-Feb,2.4,2,8.11,3,1,SK Telecom T1,27.66666667,0,0,0,3.737716667,0,8.161783333,1,0,17.56503333,3388,2325,1063,5311,3522,1789,4267,2892,1375,86,15,71,148,29,119
721567,18-Feb,2.4,2,8.11,4,1,SK Telecom T1,27.66666667,0,0,0,3.737716667,0,8.161783333,1,0,17.56503333,2848,4067,-1219,5361,5952,-591,3207,3580,-373,66,85,-19,129,146,-17
721567,18-Feb,2.4,2,8.11,5,1,SK Telecom T1,27.66666667,0,0,1,3.737716667,0,8.161783333,1,0,17.56503333,1844,2847,-1003,2978,3906,-928,1883,3198,-1315,4,28,-24,10,42,-32
721567,18-Feb,2.4,2,8.11,100,1,SK Telecom T1,27.66666667,0,0,1,3.737716667,0,8.161783333,1,0,17.56503333,14300,16111,-1811,23262,24213,-951,17295,18345,-1050,292,299,-7,496,510,-14
721794,18-Feb,2.6,1,8.11,1,1,SK Telecom T1,24.86666667,0,0,0,11.76068333,0,7.54825,1,1,11.75683333,3378,3392,-14,5941,5057,884,4758,4905,-147,94,94,0,155,145,10
721794,18-Feb,2.6,1,8.11,2,1,SK Telecom T1,24.86666667,0,1,0,11.76068333,0,7.54825,1,1,11.75683333,2167,3205,-1038,3900,4671,-771,2900,4059,-1159,3,61,-58,7,90,-83
721794,18-Feb,2.6,1,8.11,3,1,SK Telecom T1,24.86666667,0,1,0,11.76068333,1,7.54825,1,1,11.75683333,4274,3367,907,6983,5172,1811,5391,4644,747,133,96,37,189,141,48
721794,18-Feb,2.6,1,8.11,4,1,SK Telecom T1,24.86666667,0,1,0,11.76068333,0,7.54825,1,1,11.75683333,3554,3618,-64,5847,5375,472,3626,3340,286,105,96,9,158,140,18
721794,18-Feb,2.6,1,8.11,5,1,SK Telecom T1,24.86666667,1,0,0,11.76068333,0,7.54825,1,1,11.75683333,2055,2141,-86,3699,3207,492,2749,3023,-274,14,18,-4,22,32,-10
721794,18-Feb,2.6,1,8.11,100,1,SK Telecom T1,24.86666667,1,1,0,11.76068333,1,7.54825,1,1,11.75683333,15428,15723,-295,26370,23482,2888,19424,19971,-547,349,365,-16,531,548,-17
731732,18-Feb,2.6,2,8.11,6,2,SK Telecom T1,46.7,0,0,0,7.85515,0,9.51495,,0,15.27373333,2857,3276,-419,4515,5118,-603,4254,4507,-253,66,77,-11,112,135,-23
731732,18-Feb,2.6,2,8.11,7,2,SK Telecom T1,46.7,0,1,0,7.85515,1,9.51495,,0,15.27373333,3331,3495,-164,4591,5116,-525,3633,3902,-269,55,65,-10,75,103,-28
731732,18-Feb,2.6,2,8.11,8,2,SK Telecom T1,46.7,0,1,0,7.85515,0,9.51495,,0,15.27373333,3599,3323,276,5401,5382,19,5200,4577,623,97,93,4,153,145,8
731732,18-Feb,2.6,2,8.11,9,2,SK Telecom T1,46.7,0,1,0,7.85515,0,9.51495,,0,15.27373333,3730,3359,371,5558,5475,83,3299,3442,-143,80,93,-13,133,162,-29
731732,18-Feb,2.6,2,8.11,10,2,SK Telecom T1,46.7,1,0,0,7.85515,0,9.51495,,0,15.27373333,2561,1808,753,3839,2640,1199,2640,1953,687,12,0,12,23,1,22
731732,18-Feb,2.6,2,8.11,200,2,SK Telecom T1,46.7,1,1,0,7.85515,1,9.51495,,0,15.27373333,16078,15261,817,23904,23731,173,19026,18381,645,310,328,-18,496,546,-50
740148,18-Feb,3.1,1,8.12,1,1,SK Telecom T1,33.11666667,0,0,0,1.975633333,0,11.64095,0,0,12.55046667,3206,3272,-66,4742,5111,-369,4618,4939,-321,84,90,-6,122,125,-3
740148,18-Feb,3.1,1,8.12,2,1,SK Telecom T1,33.11666667,0,0,0,1.975633333,0,11.64095,0,0,12.55046667,2977,3027,-50,4731,4860,-129,3428,3674,-246,55,55,0,86,97,-11
740148,18-Feb,3.1,1,8.12,3,1,SK Telecom T1,33.11666667,0,0,0,1.975633333,0,11.64095,0,0,12.55046667,3306,3210,96,5149,5172,-23,4730,4595,135,90,85,5,146,126,20
740148,18-Feb,3.1,1,8.12,4,1,SK Telecom T1,33.11666667,0,0,0,1.975633333,0,11.64095,0,0,12.55046667,2898,3946,-1048,4063,6790,-2727,3123,3419,-296,66,89,-23,94,140,-46
740148,18-Feb,3.1,1,8.12,5,1,SK Telecom T1,33.11666667,0,0,1,1.975633333,0,11.64095,0,0,12.55046667,2014,2081,-67,2955,3914,-959,2406,2788,-382,5,16,-11,5,30,-25
740148,18-Feb,3.1,1,8.12,100,1,SK Telecom T1,33.11666667,0,0,1,1.975633333,0,11.64095,0,0,12.55046667,14401,15536,-1135,21640,25847,-4207,18305,19415,-1110,300,335,-35,453,518,-65
750149,18-Feb,3.1,2,8.12,6,2,SK Telecom T1,36.71666667,0,0,0,8.986233333,0,8.527516667,1,1,17.2574,3289,3244,45,4761,5763,-1002,4765,4728,37,88,86,2,130,135,-5
750149,18-Feb,3.1,2,8.12,7,2,SK Telecom T1,36.71666667,0,1,0,8.986233333,1,8.527516667,1,1,17.2574,3230,3065,165,4683,4764,-81,4026,3500,526,62,59,3,93,87,6
750149,18-Feb,3.1,2,8.12,8,2,SK Telecom T1,36.71666667,1,0,0,8.986233333,0,8.527516667,1,1,17.2574,3775,3358,417,5931,5287,644,4874,4889,-15,95,95,0,151,135,16
750149,18-Feb,3.1,2,8.12,9,2,SK Telecom T1,36.71666667,0,0,0,8.986233333,0,8.527516667,1,1,17.2574,3126,3564,-438,4831,5487,-656,3694,3355,339,82,92,-10,134,135,-1
750149,18-Feb,3.1,2,8.12,10,2,SK Telecom T1,36.71666667,0,1,0,8.986233333,0,8.527516667,1,1,17.2574,2051,2086,-35,3251,3255,-4,2326,2722,-396,12,18,-6,18,26,-8
750149,18-Feb,3.1,2,8.12,200,2,SK Telecom T1,36.71666667,1,1,0,8.986233333,1,8.527516667,1,1,17.2574,15471,15317,154,23457,24556,-1099,19685,19194,491,339,350,-11,526,518,8
750151,18-Feb,3.1,3,8.12,1,1,SK Telecom T1,35.43333333,0,0,0,8.684033333,0,11.8959,1,1,15.53578333,3469,3223,246,5640,5095,545,4923,4294,629,95,71,24,150,117,33
750151,18-Feb,3.1,3,8.12,2,1,SK Telecom T1,35.43333333,0,1,0,8.684033333,1,11.8959,1,1,15.53578333,3065,3140,-75,5067,4895,172,3283,3370,-87,54,58,-4,90,89,1
750151,18-Feb,3.1,3,8.12,3,1,SK Telecom T1,35.43333333,0,1,0,8.684033333,0,11.8959,1,1,15.53578333,3252,3070,182,5087,4621,466,4480,4436,44,77,80,-3,131,125,6
750151,18-Feb,3.1,3,8.12,4,1,SK Telecom T1,35.43333333,0,0,0,8.684033333,0,11.8959,1,1,15.53578333,3119,3458,-339,5071,5521,-450,3825,3480,345,80,93,-13,137,155,-18
750151,18-Feb,3.1,3,8.12,5,1,SK Telecom T1,35.43333333,1,0,0,8.684033333,0,11.8959,1,1,15.53578333,2374,1995,379,4288,3029,1259,2219,2561,-342,12,15,-3,28,26,2
750151,18-Feb,3.1,3,8.12,100,1,SK Telecom T1,35.43333333,1,1,0,8.684033333,1,11.8959,1,1,15.53578333,15279,14886,393,25153,23161,1992,18730,18141,589,318,317,1,536,512,24
740505,18-Feb,3.3,1,8.12,6,2,SK Telecom T1,32.3,0,0,0,3.291833333,0,13.55538333,1,0,15.17408333,2927,3188,-261,5103,5061,42,4079,4214,-135,63,83,-20,115,139,-24
740505,18-Feb,3.3,1,8.12,7,2,SK Telecom T1,32.3,0,0,0,3.291833333,0,13.55538333,1,0,15.17408333,2812,1992,820,4228,3016,1212,3300,2385,915,43,2,41,61,4,57
740505,18-Feb,3.3,1,8.12,8,2,SK Telecom T1,32.3,0,0,0,3.291833333,0,13.55538333,1,0,15.17408333,3449,4088,-639,6065,6482,-417,4968,5261,-293,96,118,-22,157,184,-27
740505,18-Feb,3.3,1,8.12,9,2,SK Telecom T1,32.3,0,0,0,3.291833333,0,13.55538333,1,0,15.17408333,3104,3503,-399,4897,5418,-521,3256,3599,-343,79,84,-5,133,130,3
740505,18-Feb,3.3,1,8.12,10,2,SK Telecom T1,32.3,0,0,1,3.291833333,0,13.55538333,1,0,15.17408333,2082,2030,52,3106,3472,-366,2815,2514,301,15,10,5,28,21,7
740505,18-Feb,3.3,1,8.12,200,2,SK Telecom T1,32.3,0,0,1,3.291833333,0,13.55538333,1,0,15.17408333,14374,14801,-427,23399,23449,-50,18418,17973,445,296,297,-1,494,478,16
740542,18-Feb,3.3,2,8.12,1,1,SK Telecom T1,37.71666667,1,0,0,3.756816667,0,10.47676667,0,0,13.89575,4539,2474,2065,6256,4947,1309,4835,3522,1313,88,49,39,132,89,43
740542,18-Feb,3.3,2,8.12,2,1,SK Telecom T1,37.71666667,0,1,0,3.756816667,1,10.47676667,0,0,13.89575,3035,3603,-568,4414,5798,-1384,2614,3731,-1117,44,58,-14,68,86,-18
740542,18-Feb,3.3,2,8.12,3,1,SK Telecom T1,37.71666667,0,0,0,3.756816667,0,10.47676667,0,0,13.89575,3454,3128,326,5453,5208,245,4474,4298,176,73,78,-5,130,126,4
740542,18-Feb,3.3,2,8.12,4,1,SK Telecom T1,37.71666667,0,0,0,3.756816667,0,10.47676667,0,0,13.89575,3327,3449,-122,5154,5258,-104,3253,3120,133,80,84,-4,128,137,-9
740542,18-Feb,3.3,2,8.12,5,1,SK Telecom T1,37.71666667,0,0,0,3.756816667,0,10.47676667,0,0,13.89575,2029,1976,53,3072,3284,-212,2778,2947,-169,14,18,-4,24,31,-7
740542,18-Feb,3.3,2,8.12,100,1,SK Telecom T1,37.71666667,1,1,0,3.756816667,1,10.47676667,0,0,13.89575,16384,14630,1754,24349,24495,-146,17954,17618,336,299,287,12,482,469,13
750713,18-Feb,3.5,1,8.12,6,2,SK Telecom T1,34.43333333,0,0,0,5.530533333,0,14.55858333,0,0,13.55338333,2710,3624,-914,4210,6130,-1920,4047,4976,-929,58,90,-32,101,144,-43
750713,18-Feb,3.5,1,8.12,7,2,SK Telecom T1,34.43333333,0,1,0,5.530533333,1,14.55858333,0,0,13.55338333,3174,3161,13,5453,4632,821,3646,3597,49,59,65,-6,97,91,6
750713,18-Feb,3.5,1,8.12,8,2,SK Telecom T1,34.43333333,0,1,0,5.530533333,0,14.55858333,0,0,13.55338333,3202,3148,54,4998,4914,84,4429,4811,-382,79,84,-5,135,128,7
750713,18-Feb,3.5,1,8.12,9,2,SK Telecom T1,34.43333333,1,0,0,5.530533333,0,14.55858333,0,0,13.55338333,3400,3238,162,5232,4981,251,3055,3055,0,73,86,-13,127,135,-8
750713,18-Feb,3.5,1,8.12,10,2,SK Telecom T1,34.43333333,0,1,0,5.530533333,0,14.55858333,0,0,13.55338333,2073,2097,-24,3266,3569,-303,2360,3026,-666,11,16,-5,17,27,-10
750713,18-Feb,3.5,1,8.12,200,2,SK Telecom T1,34.43333333,1,1,0,5.530533333,1,14.55858333,0,0,13.55338333,14559,15268,-709,23159,24226,-1067,17537,19465,-1928,280,341,-61,477,525,-48
750727,18-Feb,3.5,2,8.12,1,1,SK Telecom T1,39.9,0,0,0,8.343183333,0,8.005033333,,1,20.85135,3324,3189,135,5272,5065,207,4687,4103,584,87,72,15,152,130,22
750727,18-Feb,3.5,2,8.12,2,1,SK Telecom T1,39.9,0,1,0,8.343183333,1,8.005033333,,1,20.85135,3147,2939,208,4477,4929,-452,3611,3302,309,63,51,12,93,75,18
750727,18-Feb,3.5,2,8.12,3,1,SK Telecom T1,39.9,0,1,0,8.343183333,0,8.005033333,,1,20.85135,3154,3156,-2,4858,5603,-745,4323,4456,-133,76,77,-1,128,140,-12
750727,18-Feb,3.5,2,8.12,4,1,SK Telecom T1,39.9,1,0,0,8.343183333,0,8.005033333,,1,20.85135,3496,3083,413,5523,4826,697,3456,2803,653,74,75,-1,127,130,-3
750727,18-Feb,3.5,2,8.12,5,1,SK Telecom T1,39.9,0,1,0,8.343183333,0,8.005033333,,1,20.85135,2387,2306,81,3622,3760,-138,2349,2725,-376,14,17,-3,25,28,-3
750727,18-Feb,3.5,2,8.12,100,1,SK Telecom T1,39.9,1,1,0,8.343183333,1,8.005033333,,1,20.85135,15508,14673,835,23752,24183,-431,18426,17389,1037,314,292,22,525,503,22
770790,18-Feb,4.3,1,8.13,6,2,SK Telecom T1,33.1,0,0,1,5.515066667,0,5.265266667,0,0,14.39356667,3318,3499,-181,5061,5903,-842,4728,4639,89,90,79,11,132,125,7
770790,18-Feb,4.3,1,8.13,7,2,SK Telecom T1,33.1,0,0,0,5.515066667,1,5.265266667,0,0,14.39356667,2892,2989,-97,4079,4738,-659,3260,3271,-11,54,51,3,79,75,4
770790,18-Feb,4.3,1,8.13,8,2,SK Telecom T1,33.1,0,0,0,5.515066667,0,5.265266667,0,0,14.39356667,3562,3323,239,5487,5742,-255,5130,4584,546,101,92,9,161,126,35
770790,18-Feb,4.3,1,8.13,9,2,SK Telecom T1,33.1,0,0,0,5.515066667,0,5.265266667,0,0,14.39356667,3508,3360,148,5625,5820,-195,4032,3481,551,99,95,4,170,161,9
770790,18-Feb,4.3,1,8.13,10,2,SK Telecom T1,33.1,0,0,0,5.515066667,0,5.265266667,0,0,14.39356667,2123,2213,-90,3287,3571,-284,2905,2901,4,21,5,16,37,9,28
770790,18-Feb,4.3,1,8.13,200,2,SK Telecom T1,33.1,0,0,1,5.515066667,1,5.265266667,0,0,14.39356667,15403,15384,19,23539,25774,-2235,20055,18876,1179,365,322,43,579,496,83
770800,18-Feb,4.3,2,8.13,1,1,SK Telecom T1,31.16666667,0,1,0,8.043116667,0,10.13015,0,0,14.3595,2998,2993,5,4356,5655,-1299,4434,4316,118,72,72,0,112,125,-13
770800,18-Feb,4.3,2,8.13,2,1,SK Telecom T1,31.16666667,0,0,0,8.043116667,0,10.13015,0,0,14.3595,2907,2945,-38,4125,4438,-313,3200,3449,-249,56,56,0,79,85,-6
770800,18-Feb,4.3,2,8.13,3,1,SK Telecom T1,31.16666667,1,0,0,8.043116667,0,10.13015,0,0,14.3595,3707,3678,29,5683,5728,-45,4688,5726,-1038,89,102,-13,152,156,-4
770800,18-Feb,4.3,2,8.13,4,1,SK Telecom T1,31.16666667,0,1,0,8.043116667,0,10.13015,0,0,14.3595,3308,3642,-334,5150,5761,-611,3082,3695,-613,87,95,-8,145,145,0
770800,18-Feb,4.3,2,8.13,5,1,SK Telecom T1,31.16666667,0,1,0,8.043116667,0,10.13015,0,0,14.3595,2199,2108,91,3038,3318,-280,3057,2416,641,18,3,15,24,16,8
770800,18-Feb,4.3,2,8.13,100,1,SK Telecom T1,31.16666667,1,1,0,8.043116667,0,10.13015,0,0,14.3595,15119,15366,-247,22352,24900,-2548,18461,19602,-1141,322,328,-6,512,527,-15
770804,18-Feb,4.3,3,8.13,6,2,SK Telecom T1,31.48333333,1,0,0,3.815366667,0,10.15088333,1,0,12.18803333,3768,3131,637,5190,4891,299,4596,4430,166,94,82,12,133,111,22
770804,18-Feb,4.3,3,8.13,7,2,SK Telecom T1,31.48333333,0,1,0,3.815366667,1,10.15088333,1,0,12.18803333,3211,2771,440,4546,4751,-205,3251,3080,171,41,48,-7,69,79,-10
770804,18-Feb,4.3,3,8.13,8,2,SK Telecom T1,31.48333333,0,0,0,3.815366667,0,10.15088333,1,0,12.18803333,3080,3140,-60,5039,5553,-514,4391,4562,-171,71,81,-10,131,130,1
770804,18-Feb,4.3,3,8.13,9,2,SK Telecom T1,31.48333333,0,0,0,3.815366667,0,10.15088333,1,0,12.18803333,3466,3928,-462,5660,5905,-245,4621,3830,791,99,104,-5,159,159,0
770804,18-Feb,4.3,3,8.13,10,2,SK Telecom T1,31.48333333,0,0,0,3.815366667,0,10.15088333,1,0,12.18803333,1951,2146,-195,2957,3969,-1012,1966,2419,-453,7,17,-10,9,36,-27
770804,18-Feb,4.3,3,8.13,200,2,SK Telecom T1,31.48333333,1,1,0,3.815366667,1,10.15088333,1,0,12.18803333,15476,15116,360,23392,25069,-1677,18825,18321,504,312,332,-20,501,515,-14
771203,18-Feb,5.1,1,8.13,6,2,SK Telecom T1,49.2,0,1,0,6.385633333,0,6.306433333,1,0,16.31916667,3425,3152,273,5127,4564,563,4670,4581,89,77,80,-3,126,115,11
771203,18-Feb,5.1,1,8.13,7,2,SK Telecom T1,49.2,0,0,0,6.385633333,1,6.306433333,1,0,16.31916667,2771,2750,21,4224,4501,-277,2820,3141,-321,52,46,6,85,66,19
771203,18-Feb,5.1,1,8.13,8,2,SK Telecom T1,49.2,0,0,0,6.385633333,0,6.306433333,1,0,16.31916667,3758,3210,548,5666,5261,405,5959,4870,1089,109,87,22,165,141,24
771203,18-Feb,5.1,1,8.13,9,2,SK Telecom T1,49.2,1,0,0,6.385633333,0,6.306433333,1,0,16.31916667,3595,3491,104,5442,5912,-470,3578,3308,270,83,86,-3,140,146,-6
771203,18-Feb,5.1,1,8.13,10,2,SK Telecom T1,49.2,0,1,0,6.385633333,0,6.306433333,1,0,16.31916667,2234,2085,149,3317,3018,299,2474,2412,62,19,3,16,31,7,24
771203,18-Feb,5.1,1,8.13,200,2,SK Telecom T1,49.2,1,1,0,6.385633333,1,6.306433333,1,0,16.31916667,15783,14688,1095,23776,23256,520,19501,18312,1189,340,302,38,547,475,72
761090,18-Feb,5.1,2,8.13,1,1,SK Telecom T1,40.5,0,0,0,3.5202,0,13.68061667,1,1,11.43033333,2978,3290,-312,5655,4620,1035,4758,4905,-147,76,91,-15,135,125,10
761090,18-Feb,5.1,2,8.13,2,1,SK Telecom T1,40.5,0,0,0,3.5202,0,13.68061667,1,1,11.43033333,3316,3241,75,5392,4525,867,3202,3336,-134,49,51,-2,79,78,1
761090,18-Feb,5.1,2,8.13,3,1,SK Telecom T1,40.5,0,0,1,3.5202,0,13.68061667,1,1,11.43033333,3425,3330,95,5747,4630,1117,4919,4658,261,89,79,10,143,108,35
761090,18-Feb,5.1,2,8.13,4,1,SK Telecom T1,40.5,0,0,0,3.5202,0,13.68061667,1,1,11.43033333,3572,3040,532,6253,4630,1623,3513,2791,722,86,69,17,121,117,4
761090,18-Feb,5.1,2,8.13,5,1,SK Telecom T1,40.5,0,0,0,3.5202,0,13.68061667,1,1,11.43033333,2156,2089,67,3782,2938,844,2895,2626,269,2,6,-4,6,7,-1
761090,18-Feb,5.1,2,8.13,100,1,SK Telecom T1,40.5,0,0,1,3.5202,0,13.68061667,1,1,11.43033333,15447,14990,457,26829,21343,5486,19287,18316,971,302,296,6,484,435,49
761094,18-Feb,5.1,3,8.13,6,2,SK Telecom T1,29.76666667,0,0,0,8.771583333,0,9.50045,,1,19.85538333,3357,3261,96,5028,5082,-54,4622,4551,71,93,86,7,145,140,5
761094,18-Feb,5.1,3,8.13,7,2,SK Telecom T1,29.76666667,0,0,0,8.771583333,1,9.50045,,1,19.85538333,2849,3321,-472,4450,4754,-304,3035,3434,-399,55,52,3,87,78,9
761094,18-Feb,5.1,3,8.13,8,2,SK Telecom T1,29.76666667,0,0,0,8.771583333,0,9.50045,,1,19.85538333,3201,3237,-36,5022,5025,-3,4928,3695,1233,86,86,0,143,142,1
761094,18-Feb,5.1,3,8.13,9,2,SK Telecom T1,29.76666667,0,0,0,8.771583333,0,9.50045,,1,19.85538333,3183,3460,-277,5638,5525,113,3059,4684,-1625,69,98,-29,129,166,-37
761094,18-Feb,5.1,3,8.13,10,2,SK Telecom T1,29.76666667,0,0,1,8.771583333,0,9.50045,,1,19.85538333,2019,2288,-269,3350,3296,54,2285,2618,-333,0,20,-20,6,31,-25
761094,18-Feb,5.1,3,8.13,200,2,SK Telecom T1,29.76666667,0,0,1,8.771583333,1,9.50045,,1,19.85538333,14609,15567,-958,23488,23682,-194,17929,18982,-1053,303,342,-39,510,557,-47
761330,18-Feb,5.3,1,8.13,6,2,SK Telecom T1,34.81666667,0,1,0,5.502083333,0,11.3418,,0,10.59103333,3700,2964,736,5185,4450,735,5068,4165,903,93,75,18,136,113,23
761330,18-Feb,5.3,1,8.13,7,2,SK Telecom T1,34.81666667,1,0,0,5.502083333,1,11.3418,,0,10.59103333,3662,3296,366,4837,4969,-132,4060,3909,151,56,68,-12,80,100,-20
761330,18-Feb,5.3,1,8.13,8,2,SK Telecom T1,34.81666667,0,0,0,5.502083333,0,11.3418,,0,10.59103333,3538,3440,98,5434,5054,380,4957,4846,111,100,97,3,155,138,17
761330,18-Feb,5.3,1,8.13,9,2,SK Telecom T1,34.81666667,0,0,0,5.502083333,0,11.3418,,0,10.59103333,3714,3325,389,5656,5632,24,3085,3326,-241,91,94,-3,150,162,-12
761330,18-Feb,5.3,1,8.13,10,2,SK Telecom T1,34.81666667,0,0,0,5.502083333,0,11.3418,,0,10.59103333,2070,2032,38,3124,3410,-286,3026,2615,411,16,16,0,25,33,-8
761330,18-Feb,5.3,1,8.13,200,2,SK Telecom T1,34.81666667,1,1,0,5.502083333,1,11.3418,,0,10.59103333,16684,15057,1627,24236,23515,721,20196,18861,1335,356,350,6,546,546,0
761353,18-Feb,5.3,2,8.13,1,1,SK Telecom T1,35.88333333,0,0,0,11.85511667,0,3.867783333,1,1,16.37368333,3112,3412,-300,5100,4939,161,4669,4934,-265,80,95,-15,119,140,-21
761353,18-Feb,5.3,2,8.13,2,1,SK Telecom T1,35.88333333,0,0,0,11.85511667,0,3.867783333,1,1,16.37368333,3142,2707,435,4744,4130,614,3574,2732,842,63,52,11,101,83,18
761353,18-Feb,5.3,2,8.13,3,1,SK Telecom T1,35.88333333,0,0,0,11.85511667,0,3.867783333,1,1,16.37368333,3289,3451,-162,5114,5153,-39,4780,5248,-468,87,95,-8,138,144,-6
761353,18-Feb,5.3,2,8.13,4,1,SK Telecom T1,35.88333333,1,0,0,11.85511667,0,3.867783333,1,1,16.37368333,3097,3233,-136,5429,4573,856,3401,3073,328,76,87,-11,133,122,11
761353,18-Feb,5.3,2,8.13,5,1,SK Telecom T1,35.88333333,0,0,0,11.85511667,0,3.867783333,1,1,16.37368333,2150,2008,142,3563,2926,637,2803,2867,-64,18,2,16,30,9,21
761353,18-Feb,5.3,2,8.13,100,1,SK Telecom T1,35.88333333,1,0,0,11.85511667,0,3.867783333,1,1,16.37368333,14790,14811,-21,23950,21721,2229,19227,18854,373,324,331,-7,521,498,23
761362,18-Feb,5.3,3,8.13,6,2,SK Telecom T1,29.1,0,0,0,7.736,0,16.80603333,0,0,12.0462,3296,3980,-684,4957,6592,-1635,4912,4964,-52,90,102,-12,141,172,-31
761362,18-Feb,5.3,3,8.13,7,2,SK Telecom T1,29.1,0,0,0,7.736,0,16.80603333,0,0,12.0462,2972,3603,-631,4370,5338,-968,3370,4368,-998,53,75,-22,85,93,-8
761362,18-Feb,5.3,3,8.13,8,2,SK Telecom T1,29.1,0,0,1,7.736,0,16.80603333,0,0,12.0462,3258,3361,-103,5007,5532,-525,4550,4649,-99,86,73,13,138,129,9
761362,18-Feb,5.3,3,8.13,9,2,SK Telecom T1,29.1,0,0,0,7.736,0,16.80603333,0,0,12.0462,3301,3369,-68,5097,5207,-110,3022,3393,-371,68,80,-12,118,135,-17
761362,18-Feb,5.3,3,8.13,10,2,SK Telecom T1,29.1,0,0,0,7.736,0,16.80603333,0,0,12.0462,1963,2162,-199,2960,3372,-412,2049,2475,-426,2,17,-15,5,27,-22
761362,18-Feb,5.3,3,8.13,200,2,SK Telecom T1,29.1,0,0,1,7.736,0,16.80603333,0,0,12.0462,14790,16475,-1685,22391,26041,-3650,17903,19849,-1946,299,347,-48,487,556,-69
771735,18-Feb,5.5,1,8.13,1,1,SK Telecom T1,33.41666667,0,0,0,5.000766667,0,8.212266667,0,1,14.53496667,3674,3063,611,5559,4982,577,4974,4018,956,91,66,25,140,118,22
771735,18-Feb,5.5,1,8.13,2,1,SK Telecom T1,33.41666667,0,0,0,5.000766667,0,8.212266667,0,1,14.53496667,2964,2793,171,4705,4135,570,3233,2868,365,56,43,13,77,70,7
771735,18-Feb,5.5,1,8.13,3,1,SK Telecom T1,33.41666667,0,0,0,5.000766667,0,8.212266667,0,1,14.53496667,3361,3387,-26,5184,5260,-76,4887,4882,5,92,95,-3,141,154,-13
771735,18-Feb,5.5,1,8.13,4,1,SK Telecom T1,33.41666667,0,0,0,5.000766667,0,8.212266667,0,1,14.53496667,3363,3777,-414,5600,5332,268,3452,3325,127,93,94,-1,150,137,13
771735,18-Feb,5.5,1,8.13,5,1,SK Telecom T1,33.41666667,0,0,1,5.000766667,1,8.212266667,0,1,14.53496667,2096,2218,-122,3458,3307,151,2473,2987,-514,19,17,2,34,30,4
771735,18-Feb,5.5,1,8.13,100,1,SK Telecom T1,33.41666667,0,0,1,5.000766667,1,8.212266667,0,1,14.53496667,15458,15238,220,24506,23016,1490,19019,18080,939,351,315,36,542,509,33
771755,18-Feb,5.5,2,8.13,6,2,SK Telecom T1,38.36666667,0,0,0,2.9746,0,7.048633333,1,0,16.70068333,2566,3585,-1019,4340,5111,-771,4163,4556,-393,52,76,-24,106,122,-16
771755,18-Feb,5.5,2,8.13,7,2,SK Telecom T1,38.36666667,0,0,1,2.9746,0,7.048633333,1,0,16.70068333,3194,3345,-151,4763,4882,-119,3459,3086,373,48,55,-7,84,87,-3
771755,18-Feb,5.5,2,8.13,8,2,SK Telecom T1,38.36666667,0,0,0,2.9746,0,7.048633333,1,0,16.70068333,3831,3103,728,5835,5021,814,4886,4312,574,87,82,5,149,142,7
771755,18-Feb,5.5,2,8.13,9,2,SK Telecom T1,38.36666667,0,0,0,2.9746,0,7.048633333,1,0,16.70068333,3280,3426,-146,5409,5463,-54,3434,3231,203,89,95,-6,156,157,-1
771755,18-Feb,5.5,2,8.13,10,2,SK Telecom T1,38.36666667,0,0,0,2.9746,0,7.048633333,1,0,16.70068333,2339,2020,319,3700,3121,579,2650,2966,-316,2,12,-10,5,25,-20
771755,18-Feb,5.5,2,8.13,200,2,SK Telecom T1,38.36666667,0,0,1,2.9746,0,7.048633333,1,0,16.70068333,15210,15479,-269,24047,23598,449,18592,18151,441,278,320,-42,500,533,-33
772148,18-Feb,6.2,1,8.13,1,1,SK Telecom T1,31.9,0,1,0,8.916433333,0,7.967716667,1,1,14.87695,3006,3024,-18,4629,4510,119,4064,4113,-49,61,75,-14,107,116,-9
772148,18-Feb,6.2,1,8.13,2,1,SK Telecom T1,31.9,1,0,0,8.916433333,1,7.967716667,1,1,14.87695,3814,3053,761,5207,4369,838,3702,3546,156,66,53,13,89,79,10
772148,18-Feb,6.2,1,8.13,3,1,SK Telecom T1,31.9,0,0,0,8.916433333,0,7.967716667,1,1,14.87695,3530,3611,-81,5270,5607,-337,4772,4619,153,87,90,-3,139,155,-16
772148,18-Feb,6.2,1,8.13,4,1,SK Telecom T1,31.9,0,0,0,8.916433333,0,7.967716667,1,1,14.87695,3363,3652,-289,5489,5448,41,3445,3663,-218,93,100,-7,160,153,7
772148,18-Feb,6.2,1,8.13,5,1,SK Telecom T1,31.9,0,0,0,8.916433333,0,7.967716667,1,1,14.87695,2288,1938,350,4055,3096,959,2813,2362,451,0,10,-10,6,22,-16
772148,18-Feb,6.2,1,8.13,100,1,SK Telecom T1,31.9,1,1,0,8.916433333,1,7.967716667,1,1,14.87695,16001,15278,723,24650,23030,1620,18796,18303,493,307,328,-21,501,525,-24
761971,18-Feb,6.2,2,8.13,6,2,SK Telecom T1,32.01666667,1,0,0,2.078483333,0,8.558283333,0,0,20.9256,3778,3435,343,5711,5507,204,4562,4736,-174,93,96,-3,151,161,-10
761971,18-Feb,6.2,2,8.13,7,2,SK Telecom T1,32.01666667,0,1,0,2.078483333,0,8.558283333,0,0,20.9256,2938,3126,-188,4375,4910,-535,3071,3711,-640,49,62,-13,70,99,-29
761971,18-Feb,6.2,2,8.13,8,2,SK Telecom T1,32.01666667,0,0,0,2.078483333,1,8.558283333,0,0,20.9256,3423,3318,105,5394,5718,-324,4867,4874,-7,102,91,11,156,142,14
761971,18-Feb,6.2,2,8.13,9,2,SK Telecom T1,32.01666667,0,0,0,2.078483333,0,8.558283333,0,0,20.9256,3246,3048,198,5001,4925,76,3655,3045,610,86,77,9,141,131,10
761971,18-Feb,6.2,2,8.13,10,2,SK Telecom T1,32.01666667,0,0,0,2.078483333,0,8.558283333,0,0,20.9256,2111,2119,-8,3148,3619,-471,2583,2544,39,15,2,13,27,9,18
761971,18-Feb,6.2,2,8.13,200,2,SK Telecom T1,32.01666667,1,1,0,2.078483333,1,8.558283333,0,0,20.9256,15496,15046,450,23629,24679,-1050,18738,18910,-172,345,328,17,545,542,3
761979,18-Feb,6.2,3,8.13,1,1,SK Telecom T1,33.1,1,0,0,8.033616667,1,17.77116667,1,1,13.96806667,3467,3319,148,5778,4700,1078,4827,4609,218,81,81,0,141,120,21
761979,18-Feb,6.2,3,8.13,2,1,SK Telecom T1,33.1,0,1,0,8.033616667,0,17.77116667,1,1,13.96806667,3188,3192,-4,4673,4705,-32,3429,3439,-10,58,53,5,88,86,2
761979,18-Feb,6.2,3,8.13,3,1,SK Telecom T1,33.1,0,0,0,8.033616667,0,17.77116667,1,1,13.96806667,3318,3006,312,4858,4750,108,4847,4373,474,88,77,11,130,126,4
761979,18-Feb,6.2,3,8.13,4,1,SK Telecom T1,33.1,0,0,0,8.033616667,0,17.77116667,1,1,13.96806667,3341,3125,216,5474,4752,722,3427,3403,24,94,79,15,144,130,14
761979,18-Feb,6.2,3,8.13,5,1,SK Telecom T1,33.1,0,0,0,8.033616667,0,17.77116667,1,1,13.96806667,2090,2070,20,3567,3017,550,2794,2448,346,18,14,4,28,21,7
761979,18-Feb,6.2,3,8.13,100,1,SK Telecom T1,33.1,1,1,0,8.033616667,1,17.77116667,1,1,13.96806667,15404,14712,692,24350,21924,2426,19324,18272,1052,339,304,35,531,483,48
772486,18-Feb,6.4,1,8.13,6,2,SK Telecom T1,50.95,0,0,0,4.012266667,0,8.08785,1,1,13.29906667,3299,3532,-233,6036,5727,309,4523,4764,-241,77,95,-18,139,152,-13
772486,18-Feb,6.4,1,8.13,7,2,SK Telecom T1,50.95,0,1,0,4.012266667,1,8.08785,1,1,13.29906667,3410,2998,412,5327,4491,836,3614,3345,269,55,59,-4,83,82,1
772486,18-Feb,6.4,1,8.13,8,2,SK Telecom T1,50.95,0,1,0,4.012266667,0,8.08785,1,1,13.29906667,3288,3336,-48,6281,5116,1165,4716,5063,-347,85,93,-8,141,148,-7
772486,18-Feb,6.4,1,8.13,9,2,SK Telecom T1,50.95,1,0,0,4.012266667,0,8.08785,1,1,13.29906667,3749,3203,546,5309,5277,32,3126,3130,-4,94,84,10,133,139,-6
772486,18-Feb,6.4,1,8.13,10,2,SK Telecom T1,50.95,0,1,0,4.012266667,0,8.08785,1,1,13.29906667,2204,1987,217,3434,2952,482,3010,2771,239,15,4,11,26,7,19
772486,18-Feb,6.4,1,8.13,200,2,SK Telecom T1,50.95,1,1,0,4.012266667,1,8.08785,1,1,13.29906667,15950,15056,894,26387,23563,2824,18989,19073,-84,326,335,-9,522,528,-6
772509,18-Feb,6.4,2,8.13,1,1,SK Telecom T1,23.98333333,0,0,0,2.061466667,0,10.01235,1,1,11.09713333,3390,3562,-172,5544,5203,341,4651,4964,-313,77,96,-19,143,147,-4
772509,18-Feb,6.4,2,8.13,2,1,SK Telecom T1,23.98333333,0,1,0,2.061466667,1,10.01235,1,1,11.09713333,3456,3084,372,4956,4416,540,2990,2980,10,46,51,-5,77,76,1
772509,18-Feb,6.4,2,8.13,3,1,SK Telecom T1,23.98333333,0,0,0,2.061466667,0,10.01235,1,1,11.09713333,3352,2519,833,5266,4021,1245,4695,4245,450,85,53,32,137,100,37
772509,18-Feb,6.4,2,8.13,4,1,SK Telecom T1,23.98333333,1,0,0,2.061466667,0,10.01235,1,1,11.09713333,4076,2790,1286,7725,4299,3426,3449,2633,816,95,64,31,156,104,52
772509,18-Feb,6.4,2,8.13,5,1,SK Telecom T1,23.98333333,0,1,0,2.061466667,0,10.01235,1,1,11.09713333,2237,2079,158,4276,3018,1258,3091,2609,482,16,8,8,28,10,18
772509,18-Feb,6.4,2,8.13,100,1,SK Telecom T1,23.98333333,1,1,0,2.061466667,1,10.01235,1,1,11.09713333,16511,14034,2477,27767,20957,6810,18876,17431,1445,319,272,47,541,437,104
772620,18-Feb,6.6,1,8.13,1,1,SK Telecom T1,38.13333333,0,0,0,12.53456667,0,10.14731667,1,1,14.41886667,3282,3413,-131,5082,5602,-520,4995,4758,237,87,82,5,138,135,3
772620,18-Feb,6.6,1,8.13,2,1,SK Telecom T1,38.13333333,0,1,0,12.53456667,1,10.14731667,1,1,14.41886667,2844,2902,-58,4310,4237,73,2992,3132,-140,48,55,-7,80,85,-5
772620,18-Feb,6.6,1,8.13,3,1,SK Telecom T1,38.13333333,0,0,0,12.53456667,0,10.14731667,1,1,14.41886667,3352,3335,17,6217,4790,1427,4838,4835,3,93,88,5,142,128,14
772620,18-Feb,6.6,1,8.13,4,1,SK Telecom T1,38.13333333,0,1,0,12.53456667,0,10.14731667,1,1,14.41886667,3266,3349,-83,5548,4967,581,2977,3346,-369,83,92,-9,129,144,-15
772620,18-Feb,6.6,1,8.13,5,1,SK Telecom T1,38.13333333,1,0,0,12.53456667,0,10.14731667,1,1,14.41886667,2063,1931,132,3528,2854,674,2859,2845,14,14,3,11,23,6,17
772620,18-Feb,6.6,1,8.13,100,1,SK Telecom T1,38.13333333,1,1,0,12.53456667,1,10.14731667,1,1,14.41886667,14807,14930,-123,24685,22450,2235,18661,18916,-255,325,320,5,512,498,14
762489,18-Feb,6.6,2,8.13,6,2,SK Telecom T1,44.45,0,0,0,4.858133333,0,10.04605,1,0,12.95248333,3613,3331,282,5465,5174,291,4881,4765,116,90,91,-1,142,144,-2
762489,18-Feb,6.6,2,8.13,7,2,SK Telecom T1,44.45,0,0,0,4.858133333,0,10.04605,1,0,12.95248333,2586,3145,-559,4472,4532,-60,2652,3522,-870,38,62,-24,70,91,-21
762489,18-Feb,6.6,2,8.13,8,2,SK Telecom T1,44.45,0,0,1,4.858133333,0,10.04605,1,0,12.95248333,3143,3929,-786,5421,5704,-283,4331,4651,-320,77,86,-9,137,142,-5
762489,18-Feb,6.6,2,8.13,9,2,SK Telecom T1,44.45,0,0,0,4.858133333,0,10.04605,1,0,12.95248333,3430,3275,155,5297,5554,-257,3226,3263,-37,84,88,-4,139,148,-9
762489,18-Feb,6.6,2,8.13,10,2,SK Telecom T1,44.45,0,0,0,4.858133333,0,10.04605,1,0,12.95248333,1994,2017,-23,3022,3502,-480,2347,2515,-168,13,15,-2,23,31,-8
762489,18-Feb,6.6,2,8.13,200,2,SK Telecom T1,44.45,0,0,1,4.858133333,0,10.04605,1,0,12.95248333,14766,15697,-931,23677,24466,-789,17437,18716,-1279,302,342,-40,511,556,-45
762491,18-Feb,6.6,3,8.13,1,1,SK Telecom T1,40.55,0,0,0,2.260366667,0,12.27916667,1,1,12.08003333,3733,3384,349,6494,4948,1546,4007,4026,-19,62,69,-7,126,113,13
762491,18-Feb,6.6,3,8.13,2,1,SK Telecom T1,40.55,0,0,1,2.260366667,0,12.27916667,1,1,12.08003333,3629,4151,-522,5184,5635,-451,3065,3383,-318,39,53,-14,69,88,-19
762491,18-Feb,6.6,3,8.13,3,1,SK Telecom T1,40.55,0,0,0,2.260366667,0,12.27916667,1,1,12.08003333,3901,3641,260,6172,5130,1042,4558,3786,772,71,62,9,119,104,15
762491,18-Feb,6.6,3,8.13,4,1,SK Telecom T1,40.55,0,0,0,2.260366667,0,12.27916667,1,1,12.08003333,3444,3655,-211,5389,5600,-211,3282,3484,-202,90,96,-6,144,158,-14
762491,18-Feb,6.6,3,8.13,5,1,SK Telecom T1,40.55,0,0,0,2.260366667,0,12.27916667,1,1,12.08003333,2071,2062,9,3378,3345,33,2819,2542,277,14,14,0,26,37,-11
762491,18-Feb,6.6,3,8.13,100,1,SK Telecom T1,40.55,0,0,1,2.260366667,0,12.27916667,1,1,12.08003333,16778,16893,-115,26617,24658,1959,17731,17221,510,276,294,-18,484,500,-16
780218,18-Feb,7.2,1,8.14,1,1,SK Telecom T1,42.55,0,0,0,5.130133333,0,6.222,0,0,10.44306667,3477,3208,269,5045,5145,-100,4794,4360,434,81,84,-3,126,130,-4
780218,18-Feb,7.2,1,8.14,2,1,SK Telecom T1,42.55,0,0,0,5.130133333,1,6.222,0,0,10.44306667,3020,3343,-323,4465,4913,-448,3605,3264,341,57,53,4,85,80,5
780218,18-Feb,7.2,1,8.14,3,1,SK Telecom T1,42.55,0,0,1,5.130133333,0,6.222,0,0,10.44306667,3175,3596,-421,5135,5683,-548,4821,4952,-131,85,93,-8,146,158,-12
780218,18-Feb,7.2,1,8.14,4,1,SK Telecom T1,42.55,0,0,0,5.130133333,0,6.222,0,0,10.44306667,3630,3329,301,5365,5668,-303,3445,3400,45,77,94,-17,126,148,-22
780218,18-Feb,7.2,1,8.14,5,1,SK Telecom T1,42.55,0,0,0,5.130133333,0,6.222,0,0,10.44306667,2056,2139,-83,2934,3157,-223,2685,2748,-63,15,2,13,23,5,18
780218,18-Feb,7.2,1,8.14,100,1,SK Telecom T1,42.55,0,0,1,5.130133333,1,6.222,0,0,10.44306667,15358,15615,-257,22944,24566,-1622,19350,18724,626,315,326,-11,506,521,-15
780259,18-Feb,7.2,2,8.14,6,2,SK Telecom T1,46.13333333,0,0,1,10.95648333,0,9.63465,0,0,14.62468333,3113,3317,-204,4623,6179,-1556,4581,4883,-302,74,91,-17,111,141,-30
780259,18-Feb,7.2,2,8.14,7,2,SK Telecom T1,46.13333333,0,0,0,10.95648333,1,9.63465,0,0,14.62468333,2942,3148,-206,4350,4539,-189,3411,3770,-359,59,60,-1,76,82,-6
780259,18-Feb,7.2,2,8.14,8,2,SK Telecom T1,46.13333333,0,0,0,10.95648333,0,9.63465,0,0,14.62468333,3233,3382,-149,4951,6048,-1097,4802,4683,119,94,96,-2,148,158,-10
780259,18-Feb,7.2,2,8.14,9,2,SK Telecom T1,46.13333333,0,0,0,10.95648333,0,9.63465,0,0,14.62468333,3238,3387,-149,4899,5080,-181,3116,3471,-355,88,92,-4,139,138,1
780259,18-Feb,7.2,2,8.14,10,2,SK Telecom T1,46.13333333,0,0,0,10.95648333,0,9.63465,0,0,14.62468333,2015,2067,-52,3046,3398,-352,2973,2802,171,13,14,-1,24,26,-2
780259,18-Feb,7.2,2,8.14,200,2,SK Telecom T1,46.13333333,0,0,1,10.95648333,1,9.63465,0,0,14.62468333,14541,15301,-760,21869,25244,-3375,18883,19609,-726,328,353,-25,498,545,-47
780266,18-Feb,7.2,3,8.14,1,1,SK Telecom T1,32.91666667,0,0,0,8.39835,0,9.407483333,1,1,16.01031667,3099,2863,236,4887,4814,73,4742,4460,282,80,66,14,136,115,21
780266,18-Feb,7.2,3,8.14,2,1,SK Telecom T1,32.91666667,0,1,0,8.39835,0,9.407483333,1,1,16.01031667,2865,2785,80,4006,3999,7,2738,2978,-240,45,49,-4,64,68,-4
780266,18-Feb,7.2,3,8.14,3,1,SK Telecom T1,32.91666667,0,0,0,8.39835,0,9.407483333,1,1,16.01031667,3051,3458,-407,5100,5680,-580,4410,5065,-655,78,87,-9,143,150,-7
780266,18-Feb,7.2,3,8.14,4,1,SK Telecom T1,32.91666667,0,1,0,8.39835,0,9.407483333,1,1,16.01031667,3578,3265,313,5367,5164,203,2933,3227,-294,81,83,-2,133,142,-9
780266,18-Feb,7.2,3,8.14,5,1,SK Telecom T1,32.91666667,1,0,0,8.39835,0,9.407483333,1,1,16.01031667,2601,1896,705,3605,2951,654,3158,2440,718,19,13,6,29,23,6
780266,18-Feb,7.2,3,8.14,100,1,SK Telecom T1,32.91666667,1,1,0,8.39835,0,9.407483333,1,1,16.01031667,15194,14267,927,22965,22608,357,17981,18170,-189,303,298,5,505,498,7
790591,18-Feb,7.4,1,8.14,1,1,SK Telecom T1,37.23333333,0,0,0,5.054233333,0,6.854066667,1,1,14.66513333,3375,3167,208,5330,5011,319,4821,4912,-91,89,83,6,149,143,6
790591,18-Feb,7.4,1,8.14,2,1,SK Telecom T1,37.23333333,0,0,0,5.054233333,0,6.854066667,1,1,14.66513333,3263,2905,358,5137,4286,851,3584,2841,743,56,52,4,98,80,18
790591,18-Feb,7.4,1,8.14,3,1,SK Telecom T1,37.23333333,0,0,1,5.054233333,0,6.854066667,1,1,14.66513333,3192,3766,-574,5178,5827,-649,4539,4938,-399,77,93,-16,135,164,-29
790591,18-Feb,7.4,1,8.14,4,1,SK Telecom T1,37.23333333,0,0,0,5.054233333,0,6.854066667,1,1,14.66513333,3331,3462,-131,5458,5439,19,3079,3494,-415,93,100,-7,154,164,-10
790591,18-Feb,7.4,1,8.14,5,1,SK Telecom T1,37.23333333,0,0,0,5.054233333,0,6.854066667,1,1,14.66513333,2028,2073,-45,3319,3112,207,2902,3020,-118,15,16,-1,29,28,1
790591,18-Feb,7.4,1,8.14,100,1,SK Telecom T1,37.23333333,0,0,1,5.054233333,0,6.854066667,1,1,14.66513333,15189,15373,-184,24422,23675,747,18925,19205,-280,330,344,-14,565,579,-14
790603,18-Feb,7.4,2,8.14,6,2,SK Telecom T1,35.6,0,0,0,9.249533333,0,9.20825,1,0,12.976,3436,2979,457,5098,5426,-328,4883,4552,331,96,72,24,140,116,24
790603,18-Feb,7.4,2,8.14,7,2,SK Telecom T1,35.6,0,0,0,9.249533333,1,9.20825,1,0,12.976,2799,3506,-707,4450,5572,-1122,3223,3537,-314,50,57,-7,76,80,-4
790603,18-Feb,7.4,2,8.14,8,2,SK Telecom T1,35.6,0,0,0,9.249533333,0,9.20825,1,0,12.976,3722,3092,630,6337,5143,1194,4841,4700,141,94,79,15,144,131,13
790603,18-Feb,7.4,2,8.14,9,2,SK Telecom T1,35.6,0,0,0,9.249533333,0,9.20825,1,0,12.976,3748,3727,21,5580,5608,-28,3367,3378,-11,88,93,-5,139,144,-5
790603,18-Feb,7.4,2,8.14,10,2,SK Telecom T1,35.6,0,0,1,9.249533333,0,9.20825,1,0,12.976,2055,2812,-757,3206,4172,-966,2846,3108,-262,14,16,-2,24,29,-5
790603,18-Feb,7.4,2,8.14,200,2,SK Telecom T1,35.6,0,0,1,9.249533333,1,9.20825,1,0,12.976,15760,16116,-356,24671,25921,-1250,19160,19275,-115,342,317,25,523,500,23
791091,18-Feb,8.3,1,8.14,1,1,SK Telecom T1,39.45,0,0,0,5.079716667,0,11.31153333,0,0,10.95958333,2943,3276,-333,4909,4949,-40,4430,4758,-328,64,90,-26,116,134,-18
791091,18-Feb,8.3,1,8.14,2,1,SK Telecom T1,39.45,0,0,1,5.079716667,0,11.31153333,0,0,10.95958333,2867,3490,-623,4203,5191,-988,3225,3793,-568,51,66,-15,77,104,-27
791091,18-Feb,8.3,1,8.14,3,1,SK Telecom T1,39.45,0,0,0,5.079716667,0,11.31153333,0,0,10.95958333,3254,3541,-287,4955,5521,-566,4719,5052,-333,86,101,-15,138,153,-15
791091,18-Feb,8.3,1,8.14,4,1,SK Telecom T1,39.45,0,0,0,5.079716667,0,11.31153333,0,0,10.95958333,3459,3535,-76,5355,5362,-7,3236,3414,-178,89,103,-14,149,155,-6
791091,18-Feb,8.3,1,8.14,5,1,SK Telecom T1,39.45,0,0,0,5.079716667,0,11.31153333,0,0,10.95958333,2071,2496,-425,3020,3632,-612,2947,3197,-250,14,18,-4,23,27,-4
791091,18-Feb,8.3,1,8.14,100,1,SK Telecom T1,39.45,0,0,1,5.079716667,0,11.31153333,0,0,10.95958333,14594,16338,-1744,22442,24655,-2213,18557,20214,-1657,304,378,-74,503,573,-70
791123,18-Feb,8.3,2,8.14,6,2,SK Telecom T1,23.1,0,0,1,3.123983333,0,12.8494,0,0,14.09401667,3031,3243,-212,4702,5545,-843,4548,4399,149,75,73,2,124,131,-7
791123,18-Feb,8.3,2,8.14,7,2,SK Telecom T1,23.1,0,0,0,3.123983333,0,12.8494,0,0,14.09401667,3313,3604,-291,4461,6557,-2096,4024,3516,508,71,52,19,86,89,-3
791123,18-Feb,8.3,2,8.14,8,2,SK Telecom T1,23.1,0,0,0,3.123983333,0,12.8494,0,0,14.09401667,2736,3857,-1121,4211,6432,-2221,3363,4753,-1390,65,89,-24,101,131,-30
791123,18-Feb,8.3,2,8.14,9,2,SK Telecom T1,23.1,0,0,0,3.123983333,0,12.8494,0,0,14.09401667,3346,3606,-260,5078,6214,-1136,3181,3674,-493,91,103,-12,135,155,-20
791123,18-Feb,8.3,2,8.14,10,2,SK Telecom T1,23.1,0,0,0,3.123983333,0,12.8494,0,0,14.09401667,2130,2123,7,4512,3584,928,3093,2784,309,16,17,-1,28,28,0
791123,18-Feb,8.3,2,8.14,200,2,SK Telecom T1,23.1,0,0,1,3.123983333,0,12.8494,0,0,14.09401667,14556,16433,-1877,22964,28332,-5368,18209,19126,-917,318,334,-16,474,534,-60
811711,2018-2rq,R1,1,8.15,6,2,SK Telecom T1,32.21666667,0,0,0,6.765816667,0,10.9526,0,0,17.82035,3184,3313,-129,4961,5153,-192,4905,5001,-96,85,92,-7,138,149,-11
811711,2018-2rq,R1,1,8.15,7,2,SK Telecom T1,32.21666667,0,0,1,6.765816667,0,10.9526,0,0,17.82035,2974,3426,-452,4432,4772,-340,3304,3656,-352,55,62,-7,84,94,-10
811711,2018-2rq,R1,1,8.15,8,2,SK Telecom T1,32.21666667,0,0,0,6.765816667,0,10.9526,0,0,17.82035,3492,3352,140,5581,5201,380,5008,4769,239,99,84,15,167,141,26
811711,2018-2rq,R1,1,8.15,9,2,SK Telecom T1,32.21666667,0,0,0,6.765816667,0,10.9526,0,0,17.82035,3422,3433,-11,5241,5413,-172,3344,3380,-36,97,99,-2,151,159,-8
811711,2018-2rq,R1,1,8.15,10,2,SK Telecom T1,32.21666667,0,0,0,6.765816667,0,10.9526,0,0,17.82035,2059,2068,-9,2941,3016,-75,2843,2935,-92,14,17,-3,21,23,-2
811711,2018-2rq,R1,1,8.15,200,2,SK Telecom T1,32.21666667,0,0,1,6.765816667,0,10.9526,0,0,17.82035,15131,15592,-461,23156,23555,-399,19404,19741,-337,350,354,-4,561,566,-5
801842,2018-2rq,R1,2,8.15,6,2,SK Telecom T1,29.45,0,0,0,9.498966667,0,10.0507,0,0,14.8631,3238,3350,-112,4743,5506,-763,4875,4934,-59,87,92,-5,129,144,-15
801842,2018-2rq,R1,2,8.15,7,2,SK Telecom T1,29.45,0,0,1,9.498966667,0,10.0507,0,0,14.8631,2689,3199,-510,4144,5182,-1038,2725,3565,-840,42,64,-22,74,95,-21
801842,2018-2rq,R1,2,8.15,8,2,SK Telecom T1,29.45,0,0,0,9.498966667,0,10.0507,0,0,14.8631,3322,3433,-111,4651,5510,-859,4787,4801,-14,91,93,-2,126,145,-19
801842,2018-2rq,R1,2,8.15,9,2,SK Telecom T1,29.45,0,0,0,9.498966667,0,10.0507,0,0,14.8631,3051,3427,-376,4568,5930,-1362,3156,3613,-457,77,94,-17,120,145,-25
801842,2018-2rq,R1,2,8.15,10,2,SK Telecom T1,29.45,0,0,0,9.498966667,0,10.0507,0,0,14.8631,1985,2466,-481,3066,3989,-923,2048,2590,-542,12,16,-4,25,32,-7
801842,2018-2rq,R1,2,8.15,200,2,SK Telecom T1,29.45,0,0,1,9.498966667,0,10.0507,0,0,14.8631,14285,15875,-1590,21172,26117,-4945,17591,19503,-1912,309,359,-50,474,561,-87
811719,2018-2rq,R1,3,8.15,6,2,SK Telecom T1,22.9,0,0,0,6.63755,0,10.21248333,1,1,8.884666667,3469,3460,9,4974,5549,-575,4258,4971,-713,76,93,-17,122,154,-32
811719,2018-2rq,R1,3,8.15,7,2,SK Telecom T1,22.9,0,0,0,6.63755,1,10.21248333,1,1,8.884666667,3145,3387,-242,4597,4569,28,3370,4191,-821,58,72,-14,88,93,-5
811719,2018-2rq,R1,3,8.15,8,2,SK Telecom T1,22.9,1,0,0,6.63755,0,10.21248333,1,1,8.884666667,4059,3386,673,5912,4983,929,4993,4234,759,88,83,5,147,130,17
811719,2018-2rq,R1,3,8.15,9,2,SK Telecom T1,22.9,0,0,0,6.63755,0,10.21248333,1,1,8.884666667,3927,3108,819,5925,4993,932,3314,2712,602,88,77,11,150,139,11
811719,2018-2rq,R1,3,8.15,10,2,SK Telecom T1,22.9,0,0,0,6.63755,0,10.21248333,1,1,8.884666667,2166,2051,115,3269,3029,240,3138,2677,461,16,13,3,28,21,7
811719,2018-2rq,R1,3,8.15,200,2,SK Telecom T1,22.9,1,0,0,6.63755,1,10.21248333,1,1,8.884666667,16766,15392,1374,24677,23123,1554,19073,18785,288,326,338,-12,535,537,-2
811721,2018-2rq,R1,4,8.15,6,2,SK Telecom T1,46.38333333,0,0,0,19.84151667,0,9.07995,0,0,17.68515,3042,3217,-175,4860,4883,-23,4699,4728,-29,75,84,-9,134,133,1
811721,2018-2rq,R1,4,8.15,7,2,SK Telecom T1,46.38333333,1,0,0,19.84151667,0,9.07995,0,0,17.68515,3275,3148,127,4789,4493,296,3959,3742,217,64,65,-1,95,91,4
811721,2018-2rq,R1,4,8.15,8,2,SK Telecom T1,46.38333333,0,1,0,19.84151667,0,9.07995,0,0,17.68515,3261,3465,-204,5200,5464,-264,4487,4818,-331,86,100,-14,147,165,-18
811721,2018-2rq,R1,4,8.15,9,2,SK Telecom T1,46.38333333,0,0,0,19.84151667,0,9.07995,0,0,17.68515,3573,3388,185,5525,5352,173,3025,3331,-306,91,94,-3,147,158,-11
811721,2018-2rq,R1,4,8.15,10,2,SK Telecom T1,46.38333333,0,1,0,19.84151667,0,9.07995,0,0,17.68515,2077,2037,40,3055,2997,58,2863,2699,164,17,14,3,26,21,5
811721,2018-2rq,R1,4,8.15,200,2,SK Telecom T1,46.38333333,1,1,0,19.84151667,0,9.07995,0,0,17.68515,15228,15255,-27,23429,23189,240,19033,19318,-285,333,357,-24,549,568,-19
801855,2018-2rq,R1,5,8.15,6,2,SK Telecom T1,26.93333333,0,0,0,2.432283333,0,11.26903333,1,0,12.23651667,3051,3822,-771,5021,5759,-738,4552,4717,-165,77,86,-9,131,132,-1
801855,2018-2rq,R1,5,8.15,7,2,SK Telecom T1,26.93333333,0,0,1,2.432283333,0,11.26903333,1,0,12.23651667,2800,3687,-887,4433,5281,-848,3042,3804,-762,51,65,-14,80,107,-27
801855,2018-2rq,R1,5,8.15,8,2,SK Telecom T1,26.93333333,0,0,0,2.432283333,0,11.26903333,1,0,12.23651667,3265,3495,-230,5592,5102,490,4640,5059,-419,87,96,-9,137,138,-1
801855,2018-2rq,R1,5,8.15,9,2,SK Telecom T1,26.93333333,0,0,0,2.432283333,0,11.26903333,1,0,12.23651667,3279,3479,-200,4961,6000,-1039,3434,3331,103,87,103,-16,134,163,-29
801855,2018-2rq,R1,5,8.15,10,2,SK Telecom T1,26.93333333,0,0,0,2.432283333,0,11.26903333,1,0,12.23651667,2020,2031,-11,3394,3127,267,2836,2894,-58,15,16,-1,28,27,1
801855,2018-2rq,R1,5,8.15,200,2,SK Telecom T1,26.93333333,0,0,1,2.432283333,0,11.26903333,1,0,12.23651667,14415,16514,-2099,23401,25269,-1868,18504,19805,-1301,317,366,-49,510,567,-57
